//MAP CONVERTED BY dmm2tgm.py THIS HEADER COMMENT PREVENTS RECONVERSION, DO NOT REMOVE
"a" = (
/obj/structure/chair/comfy/shuttle{
	dir = 1
	},
/obj/structure/cable{
	icon_state = "1-2"
	},
/obj/effect/turf_decal/techfloor,
/turf/open/floor/plasteel/dark,
/area/ship/bridge)
"c" = (
/obj/machinery/power/smes/shuttle/micro/precharged{
	dir = 4
	},
/obj/structure/cable{
	icon_state = "0-8"
	},
/obj/structure/window/plasma/reinforced/spawner/west,
/obj/structure/window/plasma/reinforced/spawner,
/obj/structure/window/plasma/reinforced/spawner/east,
/obj/machinery/door/poddoor/preopen{
	id = "involute_window"
	},
/turf/open/floor/plating,
/area/ship/bridge)
"g" = (
/obj/structure/chair/comfy/shuttle,
/obj/structure/cable{
	icon_state = "1-2"
	},
/obj/effect/turf_decal/techfloor{
	dir = 1
	},
/turf/open/floor/plasteel/dark,
/area/ship/bridge)
"n" = (
/obj/machinery/power/terminal{
	dir = 8
	},
/obj/structure/cable{
	icon_state = "0-2"
	},
/obj/structure/grille,
/obj/structure/window/plasma/reinforced/plastitanium,
/obj/machinery/door/poddoor/preopen{
	id = "involute_window"
	},
/turf/open/floor/plating,
/area/ship/bridge)
"p" = (
/obj/machinery/power/terminal{
	dir = 8
	},
/obj/structure/cable{
	icon_state = "0-1"
	},
/obj/structure/grille,
/obj/structure/window/plasma/reinforced/plastitanium,
/obj/machinery/door/poddoor/preopen{
	id = "involute_window"
	},
/turf/open/floor/plating,
/area/ship/bridge)
"v" = (
/turf/closed/wall/mineral/plastitanium/nodiagonal,
/area/ship/bridge)
"y" = (
/obj/structure/window/plasma/reinforced/plastitanium,
/obj/structure/grille,
/obj/structure/cable{
	icon_state = "0-8"
	},
/obj/machinery/door/poddoor/preopen{
	id = "involute_window";
	dir = 4
	},
/turf/open/floor/plating,
/area/ship/bridge)
"z" = (
/obj/structure/chair/comfy/shuttle{
	dir = 4;
	pixel_x = 5
	},
/obj/structure/cable{
	icon_state = "4-8"
	},
/obj/structure/cable{
	icon_state = "1-8"
	},
/obj/effect/turf_decal/techfloor{
	dir = 4
	},
/turf/open/floor/plasteel/dark,
/area/ship/bridge)
"C" = (
/obj/structure/chair/comfy/shuttle{
	dir = 1
	},
/obj/effect/turf_decal/techfloor,
/turf/open/floor/plasteel/dark,
/area/ship/bridge)
"I" = (
/obj/machinery/power/apc/auto_name/directional/north,
/obj/structure/cable{
	icon_state = "0-2"
	},
/obj/machinery/power/terminal{
	dir = 1
	},
/obj/effect/turf_decal/techfloor{
	dir = 5
	},
/obj/machinery/light/directional/east,
/turf/open/floor/plasteel/dark,
/area/ship/bridge)
"J" = (
/obj/structure/fans/tiny,
/obj/effect/turf_decal/techfloor{
	dir = 4
	},
/obj/effect/turf_decal/techfloor{
	dir = 8
	},
/obj/machinery/door/poddoor/preopen{
	id = "involute_door";
	dir = 4
	},
/turf/open/floor/plasteel/tech/grid,
/area/ship/bridge)
"L" = (
/turf/template_noop,
/area/template_noop)
"N" = (
/obj/structure/cable{
	icon_state = "1-8"
	},
/obj/structure/cable{
	icon_state = "2-8"
	},
/obj/machinery/light/floor,
/obj/structure/cable{
	icon_state = "4-8"
	},
/turf/open/floor/plasteel/dark,
/area/ship/bridge)
"P" = (
/obj/effect/turf_decal/techfloor{
	dir = 6
	},
/obj/machinery/light/directional/east,
/obj/machinery/turretid{
	pixel_y = -28;
	pixel_x = -2
	},
/turf/open/floor/plasteel/dark,
/area/ship/bridge)
"Q" = (
/obj/machinery/power/shuttle/engine/electric{
	dir = 4;
	icon_state = "burst"
	},
/obj/structure/cable{
	icon_state = "0-4"
	},
/obj/structure/window/plasma/reinforced/spawner,
/obj/structure/window/plasma/reinforced/spawner/north,
/obj/structure/window/plasma/reinforced/spawner/east,
/turf/open/floor/plating,
/area/ship/bridge)
"R" = (
/obj/structure/cable{
	icon_state = "4-8"
	},
/obj/docking_port/mobile{
	can_move_docking_ports = 1;
	dir = 4;
	launch_status = 0;
	port_direction = 2;
	preferred_direction = 4;
	name = "involute pod"
	},
/obj/structure/fans/tiny,
/obj/effect/turf_decal/techfloor{
	dir = 4
	},
/obj/effect/turf_decal/techfloor{
	dir = 8
	},
/obj/machinery/door/poddoor/preopen{
	id = "involute_door";
	dir = 4
	},
/turf/open/floor/plasteel/tech/grid,
/area/ship/bridge)
"S" = (
/obj/structure/cable{
	icon_state = "4-8"
	},
/turf/open/floor/plasteel/dark,
/area/ship/bridge)
"T" = (
/obj/machinery/computer/helm{
	dir = 8;
	pixel_x = 5;
	density = 0
	},
/obj/structure/cable{
	icon_state = "4-8"
	},
/obj/effect/turf_decal/techfloor{
	dir = 8
	},
/obj/item/radio/intercom/wideband/directional/north{
	pixel_y = 32;
	pixel_x = 2
	},
/obj/machinery/button/door{
	id = "involute_door";
	name = "Pod Doors";
	pixel_y = -26;
	pixel_x = -2
	},
/obj/machinery/button/door{
	id = "involute_window";
	name = "Pod Windows";
	pixel_y = -26;
	pixel_x = 10
	},
/obj/item/radio/intercom/directional/north{
	pixel_y = 46;
	pixel_x = 2
	},
/turf/open/floor/plasteel/dark,
/area/ship/bridge)
"U" = (
/obj/structure/chair/comfy/shuttle,
/obj/effect/turf_decal/techfloor{
	dir = 1
	},
/turf/open/floor/plasteel/dark,
/area/ship/bridge)
"V" = (
/obj/machinery/power/shuttle/engine/electric{
	dir = 4;
	icon_state = "burst"
	},
/obj/structure/cable{
	icon_state = "0-4"
	},
/obj/structure/window/plasma/reinforced/spawner/north,
/obj/structure/window/plasma/reinforced/spawner,
/obj/structure/window/plasma/reinforced/spawner/east,
/turf/open/floor/plating,
/area/ship/bridge)
"W" = (
/obj/machinery/porta_turret/ship/ballistic,
/turf/closed/wall/mineral/plastitanium/nodiagonal,
/area/ship/bridge)
"Y" = (
/obj/machinery/power/smes/shuttle/micro/precharged{
	dir = 4
	},
/obj/structure/cable{
	icon_state = "0-8"
	},
/obj/structure/window/plasma/reinforced/spawner/north,
/obj/structure/window/plasma/reinforced/spawner/west,
/obj/structure/window/plasma/reinforced/spawner/east,
/obj/machinery/door/poddoor/preopen{
	id = "involute_window"
	},
/turf/open/floor/plating,
/area/ship/bridge)

(1,1,1) = {"
Q
J
R
J
V
"}
(2,1,1) = {"
Y
U
S
C
c
"}
(3,1,1) = {"
n
g
N
a
p
"}
(4,1,1) = {"
v
I
z
P
v
"}
(5,1,1) = {"
W
v
T
v
W
"}
(6,1,1) = {"
L
v
y
v
L
"}
