//MAP CONVERTED BY dmm2tgm.py THIS HEADER COMMENT PREVENTS RECONVERSION, DO NOT REMOVE
"a" = (
/turf/template_noop,
/area/template_noop)
"b" = (
/turf/closed/wall,
/area/ship/engineering)
"c" = (
/obj/machinery/power/shuttle/engine/electric/bad{
	dir = 4;
	icon_state = "burst"
	},
/obj/structure/cable{
	icon_state = "0-4"
	},
/turf/open/floor/plating,
/area/ship/external)
"d" = (
/obj/machinery/door/airlock/maintenance_hatch,
/obj/structure/fans/tiny,
/obj/docking_port/mobile{
	can_move_docking_ports = 1;
	dir = 2;
	launch_status = 0;
	port_direction = 8;
	preferred_direction = 4
	},
/turf/open/floor/plating,
/area/ship/engineering)
"e" = (
/obj/structure/window/reinforced{
	dir = 1;
	icon_state = "rwindow"
	},
/obj/item/storage/toolbox/mechanical{
	pixel_x = -1;
	pixel_y = 5
	},
/obj/item/storage/toolbox/electrical{
	pixel_x = -1;
	pixel_y = 1
	},
/obj/item/storage/belt/utility,
/obj/structure/rack,
/obj/effect/decal/cleanable/glass,
/turf/open/floor/plating,
/area/ship/engineering)
"f" = (
/obj/machinery/power/smes/shuttle/precharged{
	dir = 4;
	icon_state = "smes"
	},
/obj/structure/cable{
	icon_state = "0-8"
	},
/obj/structure/window/reinforced{
	dir = 8;
	icon_state = "rwindow"
	},
/turf/open/floor/plating,
/area/ship/engineering)
"g" = (
/obj/machinery/power/terminal{
	dir = 8;
	icon_state = "term"
	},
/obj/structure/cable{
	icon_state = "0-4"
	},
/turf/open/floor/plating,
/area/ship/engineering)
"h" = (
/obj/structure/cable{
	icon_state = "2-8"
	},
/obj/effect/decal/cleanable/dirt,
/obj/effect/decal/cleanable/dirt,
/obj/effect/decal/cleanable/dirt,
/turf/open/floor/plating,
/area/ship/engineering)
"i" = (
/obj/effect/decal/cleanable/dirt,
/turf/open/floor/plating,
/area/ship/engineering)
"j" = (
/obj/machinery/autolathe,
/turf/open/floor/plating,
/area/ship/engineering)
"k" = (
/obj/structure/cable{
	icon_state = "1-2"
	},
/turf/open/floor/plating,
/area/ship/engineering)
"l" = (
/turf/closed/wall,
/area/ship/bridge)
"m" = (
/obj/structure/window/reinforced{
	dir = 1;
	icon_state = "rwindow"
	},
/obj/structure/rack,
/obj/item/clothing/head/helmet/riot,
/obj/item/clothing/suit/armor/vest/alt,
/obj/item/gun/ballistic/derringer,
/obj/item/areaeditor/shuttle,
/obj/item/radio{
	desc = "An old handheld radio. You could use it, if you really wanted to.";
	icon_state = "radio";
	name = "old radio";
	pixel_x = 2;
	pixel_y = 3
	},
/turf/open/floor/plating,
/area/ship/bridge)
"n" = (
/obj/effect/spawner/structure/window/reinforced,
/turf/open/floor/plating,
/area/ship/bridge)
"o" = (
/obj/structure/window/reinforced{
	dir = 1;
	icon_state = "rwindow"
	},
/obj/structure/rack,
/obj/item/pickaxe/improvised,
/obj/item/storage/bag/ore,
/obj/item/radio{
	desc = "An old handheld radio. You could use it, if you really wanted to.";
	icon_state = "radio";
	name = "old radio";
	pixel_x = 2;
	pixel_y = 3
	},
/turf/open/floor/plating,
/area/ship/engineering)
"p" = (
/obj/structure/window/reinforced{
	dir = 1;
	icon_state = "rwindow"
	},
/obj/machinery/suit_storage_unit/inherit,
/obj/item/clothing/head/helmet/space/light,
/obj/item/clothing/suit/space/eva,
/turf/open/floor/plating,
/area/ship/engineering)
"q" = (
/obj/structure/cable{
	icon_state = "1-2"
	},
/obj/effect/decal/cleanable/generic,
/obj/effect/decal/cleanable/dirt,
/obj/effect/decal/cleanable/dirt,
/obj/effect/decal/cleanable/dirt,
/obj/effect/decal/cleanable/dirt,
/obj/effect/decal/cleanable/dirt,
/obj/effect/decal/cleanable/dirt,
/turf/open/floor/plating,
/area/ship/engineering)
"r" = (
/turf/open/floor/plating,
/area/ship/bridge)
"s" = (
/obj/machinery/door/airlock/maintenance{
	dir = 8;
	icon_state = "closed"
	},
/obj/structure/barricade/wooden/crude,
/obj/structure/barricade/wooden,
/turf/open/floor/plating,
/area/ship/engineering)
"t" = (
/obj/structure/cable{
	icon_state = "1-2"
	},
/obj/effect/decal/cleanable/dirt,
/obj/effect/decal/cleanable/dirt,
/obj/effect/decal/cleanable/dirt,
/obj/effect/decal/cleanable/dirt,
/obj/effect/decal/cleanable/dirt,
/mob/living/simple_animal/hostile/rat,
/turf/open/floor/plating,
/area/ship/engineering)
"u" = (
/obj/machinery/door/airlock/maintenance_hatch{
	dir = 8;
	icon_state = "closed"
	},
/obj/structure/cable{
	icon_state = "4-8"
	},
/turf/open/floor/plating,
/area/ship/engineering)
"v" = (
/obj/structure/cable{
	icon_state = "4-8"
	},
/turf/open/floor/plating,
/area/ship/engineering)
"w" = (
/obj/structure/cable{
	icon_state = "1-2"
	},
/obj/effect/decal/cleanable/oil,
/obj/effect/decal/cleanable/dirt,
/turf/open/floor/plating,
/area/ship/engineering)
"x" = (
/obj/structure/cable{
	icon_state = "0-2"
	},
/obj/machinery/power/apc/auto_name/directional/west,
/obj/effect/decal/cleanable/dirt,
/obj/effect/decal/cleanable/dirt,
/mob/living/simple_animal/hostile/rat,
/turf/open/floor/plating,
/area/ship/bridge)
"y" = (
/obj/effect/decal/cleanable/dirt,
/obj/effect/decal/cleanable/dirt,
/obj/effect/decal/cleanable/dirt,
/turf/open/floor/plating,
/area/ship/bridge)
"z" = (
/obj/structure/window/reinforced,
/obj/machinery/computer/cryopod/directional/west,
/obj/machinery/cryopod{
	dir = 1;
	icon_state = "cryopod-open"
	},
/turf/open/floor/plating,
/area/ship/engineering)
"A" = (
/obj/structure/window/reinforced,
/obj/structure/reagent_dispensers/fueltank,
/obj/effect/decal/cleanable/vomit/old,
/turf/open/floor/plating,
/area/ship/engineering)
"B" = (
/obj/structure/window/reinforced,
/obj/structure/rack,
/obj/item/grenade/frag,
/obj/item/grenade/frag,
/obj/item/grenade/empgrenade,
/turf/open/floor/plating,
/area/ship/bridge)
"C" = (
/obj/effect/spawner/structure/window/reinforced,
/obj/effect/decal/cleanable/dirt,
/turf/open/floor/plating,
/area/ship/bridge)
"D" = (
/obj/structure/cable{
	icon_state = "1-2"
	},
/obj/structure/cable{
	icon_state = "2-4"
	},
/obj/structure/cable{
	icon_state = "1-4"
	},
/obj/effect/decal/cleanable/glass,
/obj/effect/decal/cleanable/dirt,
/mob/living/simple_animal/hostile/rat,
/turf/open/floor/plating,
/area/ship/engineering)
"E" = (
/obj/structure/cable{
	icon_state = "4-8"
	},
/obj/effect/decal/cleanable/oil/slippery,
/obj/effect/decal/cleanable/dirt,
/turf/open/floor/plating,
/area/ship/engineering)
"F" = (
/obj/machinery/power/port_gen/pacman,
/obj/structure/cable{
	icon_state = "0-8"
	},
/turf/open/floor/plating,
/area/ship/engineering)
"G" = (
/obj/structure/window/reinforced,
/obj/structure/cable,
/obj/machinery/power/smes/engineering,
/turf/open/floor/plating,
/area/ship/engineering)
"H" = (
/obj/structure/window/reinforced,
/obj/machinery/power/terminal{
	dir = 8;
	icon_state = "term"
	},
/obj/structure/cable,
/turf/open/floor/plating,
/area/ship/engineering)
"J" = (
/obj/structure/cable{
	icon_state = "4-8"
	},
/obj/effect/decal/cleanable/dirt,
/turf/open/floor/plating,
/area/ship/engineering)
"K" = (
/obj/structure/cable{
	icon_state = "4-8"
	},
/obj/effect/decal/cleanable/oil/streak,
/turf/open/floor/plating,
/area/ship/engineering)
"L" = (
/obj/structure/cable{
	icon_state = "4-8"
	},
/obj/effect/decal/cleanable/generic,
/obj/effect/decal/cleanable/dirt,
/turf/open/floor/plating,
/area/ship/engineering)
"M" = (
/obj/machinery/door/airlock/maintenance_hatch{
	dir = 8;
	icon_state = "closed"
	},
/obj/structure/cable{
	icon_state = "4-8"
	},
/obj/effect/decal/cleanable/dirt,
/turf/open/floor/plating,
/area/ship/bridge)
"N" = (
/obj/effect/decal/cleanable/molten_object,
/turf/open/floor/plating,
/area/ship/engineering)
"O" = (
/obj/structure/cable{
	icon_state = "4-8"
	},
/obj/effect/decal/cleanable/wrapping,
/turf/open/floor/plating,
/area/ship/engineering)
"P" = (
/obj/machinery/computer/helm/retro{
	dir = 8;
	icon_state = "computer-retro"
	},
/obj/effect/decal/cleanable/dirt,
/obj/effect/decal/cleanable/dirt,
/turf/open/floor/plating,
/area/ship/bridge)
"Q" = (
/obj/effect/decal/cleanable/dirt,
/turf/closed/wall,
/area/ship/bridge)
"R" = (
/obj/effect/decal/cleanable/oil,
/obj/effect/decal/cleanable/dirt,
/obj/effect/decal/cleanable/dirt,
/turf/open/floor/plating,
/area/ship/bridge)
"S" = (
/obj/machinery/door/airlock/maintenance_hatch{
	dir = 1;
	icon_state = "closed"
	},
/obj/structure/cable{
	icon_state = "1-2"
	},
/obj/effect/decal/cleanable/dirt,
/obj/effect/decal/cleanable/dirt,
/turf/open/floor/plating,
/area/ship/engineering)
"T" = (
/obj/effect/decal/cleanable/dirt,
/turf/closed/wall,
/area/ship/engineering)
"U" = (
/obj/structure/cable{
	icon_state = "1-2"
	},
/obj/structure/cable{
	icon_state = "2-8"
	},
/obj/structure/cable{
	icon_state = "2-4"
	},
/obj/effect/decal/cleanable/dirt,
/obj/effect/decal/cleanable/dirt,
/obj/effect/decal/cleanable/dirt,
/obj/effect/decal/cleanable/dirt,
/obj/effect/decal/cleanable/dirt,
/obj/effect/decal/cleanable/dirt,
/turf/open/floor/plating,
/area/ship/engineering)
"V" = (
/obj/structure/cable{
	icon_state = "2-4"
	},
/obj/machinery/power/apc/auto_name/directional/north,
/obj/structure/cable{
	icon_state = "0-8"
	},
/obj/effect/decal/cleanable/dirt,
/obj/effect/decal/cleanable/dirt,
/obj/effect/decal/cleanable/dirt,
/obj/effect/decal/cleanable/dirt,
/mob/living/simple_animal/hostile/rat,
/turf/open/floor/plating,
/area/ship/engineering)
"W" = (
/obj/structure/cable{
	icon_state = "1-8"
	},
/obj/structure/chair/plastic{
	dir = 4;
	icon_state = "plastic_chair"
	},
/obj/effect/decal/cleanable/dirt,
/obj/effect/decal/cleanable/dirt,
/obj/effect/decal/cleanable/dirt,
/obj/effect/decal/cleanable/vomit,
/turf/open/floor/plating,
/area/ship/bridge)
"X" = (
/obj/structure/cable{
	icon_state = "4-8"
	},
/obj/effect/decal/cleanable/dirt,
/obj/effect/decal/cleanable/garbage,
/turf/open/floor/plating,
/area/ship/engineering)
"Y" = (
/obj/structure/cable{
	icon_state = "1-2"
	},
/obj/effect/decal/cleanable/blood/old,
/turf/open/floor/plating,
/area/ship/engineering)
"Z" = (
/obj/docking_port/mobile{
	dir = 4;
	port_direction = 2;
	preferred_direction = 4
	},
/turf/template_noop,
/area/template_noop)

(1,1,1) = {"
a
c
a
a
a
Z
a
a
a
c
a
"}
(2,1,1) = {"
b
f
b
a
a
a
a
a
b
f
b
"}
(3,1,1) = {"
b
g
b
b
b
s
b
b
b
g
b
"}
(4,1,1) = {"
d
h
q
t
w
D
k
Y
S
U
G
"}
(5,1,1) = {"
e
i
b
b
b
u
b
b
T
V
H
"}
(6,1,1) = {"
b
N
b
a
b
O
b
a
b
X
b
"}
(7,1,1) = {"
b
j
b
a
b
K
b
a
b
F
b
"}
(8,1,1) = {"
b
b
b
a
b
v
b
a
b
b
b
"}
(9,1,1) = {"
a
a
a
a
o
E
z
a
a
a
a
"}
(10,1,1) = {"
a
a
a
a
p
J
A
a
a
a
a
"}
(11,1,1) = {"
a
a
a
a
b
L
b
a
a
a
a
"}
(12,1,1) = {"
a
a
a
a
b
v
b
a
a
a
a
"}
(13,1,1) = {"
a
a
a
l
l
M
Q
l
a
a
a
"}
(14,1,1) = {"
a
a
a
l
x
W
R
l
a
a
a
"}
(15,1,1) = {"
a
a
a
m
y
P
r
B
a
a
a
"}
(16,1,1) = {"
a
a
a
n
C
n
n
n
a
a
a
"}
