//MAP CONVERTED BY dmm2tgm.py THIS HEADER COMMENT PREVENTS RECONVERSION, DO NOT REMOVE
"a" = (
/turf/template_noop,
/area/template_noop)
"b" = (
/turf/closed/wall/mineral/plastitanium/nodiagonal,
/area/ship/bridge)
"c" = (
/obj/effect/spawner/structure/window/plasma/reinforced/plastitanium,
/obj/machinery/door/poddoor/preopen{
	id = 12344;
	name = "Lockdown"
	},
/turf/open/floor/plating,
/area/ship/bridge)
"d" = (
/obj/structure/fans/tiny,
/obj/machinery/door/poddoor{
	id = 5434
	},
/turf/open/floor/plasteel/mono/dark,
/area/ship/bridge)
"e" = (
/obj/machinery/power/port_gen/pacman,
/obj/machinery/power/terminal{
	dir = 4
	},
/obj/item/stack/sheet/mineral/plasma/fifty,
/turf/open/floor/plasteel/dark,
/area/ship/bridge)
"f" = (
/obj/machinery/power/smes/engineering,
/obj/structure/cable{
	icon_state = "0-2"
	},
/obj/machinery/button/door{
	id = 5434;
	name = "Poddoors";
	pixel_y = 24
	},
/obj/machinery/light/directional/north,
/turf/open/floor/plasteel/dark,
/area/ship/bridge)
"g" = (
/turf/open/floor/plasteel/dark,
/area/ship/bridge)
"h" = (
/obj/structure/closet/wall/white/med{
	dir = 8;
	icon_state = "freezer_wall";
	pixel_x = 30
	},
/obj/item/healthanalyzer/advanced,
/obj/item/hypospray/mkii,
/obj/item/storage/firstaid/tactical,
/obj/item/storage/firstaid/o2,
/obj/item/storage/firstaid/toxin,
/obj/item/defibrillator/compact/combat/loaded,
/obj/item/reagent_containers/hypospray/combat,
/obj/item/reagent_containers/food/snacks/mre_course/main/beans,
/obj/item/reagent_containers/food/snacks/mre_course/side/bread,
/obj/item/reagent_containers/food/snacks/mre_course/dessert/cake,
/turf/open/floor/plasteel/dark,
/area/ship/bridge)
"i" = (
/obj/effect/spawner/structure/window/plasma/reinforced/plastitanium,
/obj/machinery/door/poddoor/preopen{
	id = 12344;
	name = "Lockdown"
	},
/turf/open/floor/plasteel/dark,
/area/ship/bridge)
"j" = (
/obj/machinery/power/shuttle/engine/electric{
	dir = 4;
	icon_state = "burst"
	},
/obj/structure/cable{
	icon_state = "0-4"
	},
/turf/open/floor/plating,
/area/ship/bridge)
"k" = (
/obj/machinery/power/smes/shuttle/precharged{
	dir = 4;
	icon_state = "smes"
	},
/obj/structure/window/plasma/reinforced{
	dir = 8;
	icon_state = "plasmarwindow"
	},
/obj/structure/window/plasma/reinforced,
/obj/structure/window/plasma/reinforced{
	dir = 1;
	icon_state = "plasmarwindow"
	},
/obj/machinery/door/window/brigdoor{
	dir = 4;
	icon_state = "leftsecure"
	},
/obj/structure/cable{
	icon_state = "0-8"
	},
/turf/open/floor/plating,
/area/ship/bridge)
"l" = (
/obj/machinery/power/terminal{
	dir = 8
	},
/obj/structure/cable{
	icon_state = "0-4"
	},
/turf/open/floor/plasteel/dark,
/area/ship/bridge)
"m" = (
/obj/structure/cable{
	icon_state = "1-2"
	},
/obj/structure/cable{
	icon_state = "1-4"
	},
/obj/structure/cable{
	icon_state = "1-8"
	},
/turf/open/floor/plasteel/dark,
/area/ship/bridge)
"n" = (
/obj/structure/cable{
	icon_state = "4-8"
	},
/turf/open/floor/plasteel/dark,
/area/ship/bridge)
"o" = (
/obj/structure/window/reinforced{
	dir = 8;
	icon_state = "rwindow"
	},
/obj/machinery/autolathe/hacked,
/obj/structure/cable{
	icon_state = "4-8"
	},
/obj/machinery/button/door{
	id = 12344;
	name = "Lockdown";
	pixel_x = 6;
	pixel_y = 24
	},
/obj/machinery/light/directional/north,
/turf/open/floor/plasteel/mono/dark,
/area/ship/bridge)
"p" = (
/obj/machinery/power/apc/auto_name/directional/north,
/obj/structure/chair/comfy/shuttle{
	desc = "STOP! YOU'RE GOING TO TEST THIS SHIP RIGHT INTO AN ICEBERG!";
	dir = 4;
	name = "Helmsman"
	},
/obj/structure/cable{
	icon_state = "0-8"
	},
/obj/effect/landmark/start/nukeop_leader,
/turf/open/floor/plasteel/dark,
/area/ship/bridge)
"q" = (
/obj/machinery/computer/helm{
	dir = 8
	},
/turf/open/floor/plasteel/dark,
/area/ship/bridge)
"r" = (
/obj/structure/cable{
	icon_state = "1-8"
	},
/turf/open/floor/plasteel/dark,
/area/ship/bridge)
"s" = (
/obj/machinery/door/window/brigdoor/eastleft{
	dir = 8;
	icon_state = "leftsecure"
	},
/obj/machinery/light/directional/south,
/obj/item/radio/intercom/directional/south{
	icon_state = "intercom"
	},
/turf/open/floor/plasteel/mono/dark,
/area/ship/bridge)
"t" = (
/obj/item/radio/intercom/wideband/directional/south{
	icon_state = "intercom-wideband";
	step_x = 0;
	step_y = 0
	},
/turf/open/floor/plasteel/dark,
/area/ship/bridge)
"u" = (
/obj/machinery/cryopod{
	dir = 8;
	icon_state = "cryopod-open"
	},
/obj/structure/sign/poster/contraband/fun_police{
	pixel_y = -31
	},
/obj/machinery/computer/cryopod/directional/east{
	icon_state = "wallconsole_old"
	},
/turf/open/floor/plasteel/dark,
/area/ship/bridge)
"v" = (
/obj/structure/rack,
/obj/item/storage/toolbox/electrical,
/obj/item/storage/toolbox/mechanical,
/obj/item/holosign_creator/atmos,
/obj/item/storage/bag/ore,
/obj/item/stack/sheet/metal/fifty,
/obj/item/stack/sheet/glass/fifty,
/obj/item/stack/sheet/mineral/plasma/fifty,
/obj/item/tank/internals/oxygen,
/obj/item/pickaxe/mini,
/obj/machinery/light/directional/south,
/turf/open/floor/plasteel/dark,
/area/ship/bridge)
"w" = (
/obj/machinery/suit_storage_unit/syndicate,
/turf/open/floor/plasteel/dark,
/area/ship/bridge)
"x" = (
/obj/structure/closet/wall/red{
	dir = 8;
	icon_state = "sec_wall";
	pixel_x = 30
	},
/obj/item/storage/belt/military,
/obj/item/clothing/head/helmet/marine,
/obj/item/clothing/suit/armor/vest/marine/medium,
/obj/item/gun/ballistic/automatic/smg/cm5,
/obj/item/gun/ballistic/revolver,
/obj/item/melee/classic_baton/telescopic/contractor_baton,
/obj/item/clothing/under/syndicate/skirt/maid,
/obj/item/clothing/under/syndicate/coldres,
/obj/item/construction/rcd/combat,
/obj/item/kitchen/knife/combat,
/obj/item/clothing/gloves/combat/maid,
/obj/item/clothing/gloves/krav_maga/combatglovesplus,
/obj/item/clothing/shoes/combat/swat,
/obj/item/ammo_box/magazine/smgm9mm,
/obj/item/ammo_box/magazine/smgm9mm,
/obj/item/ammo_box/magazine/smgm9mm,
/obj/item/ammo_box/a357,
/obj/item/ammo_box/a357,
/turf/open/floor/plasteel/dark,
/area/ship/bridge)
"y" = (
/turf/closed/wall/mineral/plastitanium,
/area/ship/bridge)
"z" = (
/obj/structure/fans/tiny,
/obj/machinery/door/poddoor{
	id = 5434
	},
/obj/docking_port/mobile{
	dir = 2;
	icon_state = "pinonclose"
	},
/turf/open/floor/plasteel/mono/dark,
/area/ship/bridge)
"H" = (
/obj/effect/spawner/structure/window/plasma/reinforced/plastitanium,
/obj/machinery/door/poddoor/preopen{
	dir = 4;
	id = 12344;
	name = "Lockdown"
	},
/turf/open/floor/plasteel/dark,
/area/ship/bridge)
"J" = (
/obj/structure/fans/tiny,
/obj/machinery/door/poddoor{
	id = 5434
	},
/obj/docking_port/mobile{
	dir = 2;
	launch_status = 0
	},
/turf/open/floor/plasteel/mono/dark,
/area/ship/bridge)
"S" = (
/obj/effect/spawner/structure/window/plasma/reinforced/plastitanium,
/obj/machinery/door/poddoor/preopen{
	id = 12344;
	name = "Lockdown"
	},
/obj/machinery/door/poddoor/preopen{
	dir = 4;
	id = 12344;
	name = "Lockdown"
	},
/turf/open/floor/plasteel/dark,
/area/ship/bridge)

(1,1,1) = {"
b
a
j
j
a
b
"}
(2,1,1) = {"
b
b
k
k
b
b
"}
(3,1,1) = {"
c
e
l
l
w
c
"}
(4,1,1) = {"
b
f
m
r
v
b
"}
(5,1,1) = {"
z
g
n
g
g
d
"}
(6,1,1) = {"
J
h
n
g
x
d
"}
(7,1,1) = {"
y
b
o
s
b
y
"}
(8,1,1) = {"
a
b
p
t
b
a
"}
(9,1,1) = {"
a
i
q
u
b
a
"}
(10,1,1) = {"
a
S
H
b
y
a
"}
