//MAP CONVERTED BY dmm2tgm.py THIS HEADER COMMENT PREVENTS RECONVERSION, DO NOT REMOVE
"aa" = (
/turf/template_noop,
/area/template_noop)
"ab" = (
/turf/closed/wall,
/area/ship/bridge)
"ac" = (
/obj/structure/window/reinforced/fulltile,
/turf/open/floor/plating,
/area/ship/bridge)
"ad" = (
/turf/closed/wall,
/area/ship/maintenance/central)
"ae" = (
/obj/machinery/modular_computer/console,
/turf/open/floor/plating,
/area/ship/bridge)
"af" = (
/obj/machinery/computer/helm,
/turf/open/floor/plating,
/area/ship/bridge)
"ag" = (
/obj/machinery/rnd/server,
/turf/open/floor/plating,
/area/ship/bridge)
"ah" = (
/turf/closed/wall/rust,
/area/ship/maintenance/central)
"ai" = (
/obj/machinery/power/apc/auto_name/directional/north,
/obj/structure/cable{
	icon_state = "0-2"
	},
/obj/item/reagent_containers/food/snacks/burger/rat,
/turf/open/floor/plating,
/area/ship/maintenance/central)
"aj" = (
/turf/closed/wall/rust,
/area/ship/bridge)
"ak" = (
/obj/machinery/power/apc/auto_name/directional/west,
/obj/structure/cable{
	icon_state = "0-4"
	},
/obj/effect/landmark/start/assistant,
/obj/item/areaeditor/shuttle,
/turf/open/floor/plating,
/area/ship/bridge)
"al" = (
/obj/structure/cable{
	icon_state = "4-8"
	},
/obj/machinery/atmospherics/components/unary/vent_pump/on/layer4{
	dir = 4;
	icon_state = "vent_map_on-4"
	},
/obj/machinery/light/small/directional/south,
/turf/open/floor/plating/rust,
/area/ship/bridge)
"am" = (
/obj/structure/cable{
	icon_state = "2-8"
	},
/obj/machinery/atmospherics/pipe/simple/supply/hidden/layer4{
	dir = 10;
	icon_state = "pipe11-4"
	},
/obj/machinery/atmospherics/components/unary/vent_scrubber/on/layer2,
/obj/machinery/airalarm/directional/east,
/turf/open/floor/plating/rust,
/area/ship/bridge)
"an" = (
/obj/structure/closet/cabinet,
/obj/item/storage/belt/utility/full,
/obj/item/storage/belt/fannypack/black,
/obj/item/storage/backpack/industrial,
/obj/item/storage/backpack/industrial,
/obj/item/storage/backpack/industrial,
/obj/item/clothing/under/misc/assistantformal,
/obj/item/gun/ballistic/revolver,
/turf/open/floor/plating,
/area/ship/maintenance/central)
"ao" = (
/obj/structure/cable{
	icon_state = "1-2"
	},
/obj/machinery/atmospherics/components/unary/vent_pump/on/layer4,
/obj/machinery/light/small/broken/directional/east{
	icon_state = "bulb-broken"
	},
/turf/open/floor/plating/rust,
/area/ship/maintenance/central)
"ap" = (
/obj/structure/cable{
	icon_state = "1-2"
	},
/obj/machinery/door/airlock/maintenance_hatch,
/obj/machinery/atmospherics/pipe/simple/supply/hidden/layer4,
/obj/machinery/atmospherics/pipe/simple/scrubbers/hidden/layer2,
/turf/open/floor/plating,
/area/ship/bridge)
"aq" = (
/obj/structure/window/reinforced/fulltile,
/turf/open/floor/plating,
/area/ship/maintenance/central)
"ar" = (
/obj/item/storage/bag/ore,
/obj/machinery/airalarm/directional/north,
/turf/open/floor/plating,
/area/ship/maintenance/central)
"as" = (
/obj/machinery/atmospherics/components/unary/vent_scrubber/on/layer2{
	dir = 4;
	icon_state = "scrub_map_on-2"
	},
/turf/open/floor/plating/rust,
/area/ship/maintenance/central)
"at" = (
/obj/structure/cable{
	icon_state = "1-4"
	},
/obj/machinery/atmospherics/pipe/simple/supply/hidden/layer4{
	dir = 5;
	icon_state = "pipe11-4"
	},
/obj/machinery/atmospherics/pipe/simple/scrubbers/hidden/layer2{
	dir = 8;
	icon_state = "pipe11-2"
	},
/turf/open/floor/plating,
/area/ship/maintenance/central)
"au" = (
/obj/structure/cable{
	icon_state = "4-8"
	},
/obj/machinery/door/airlock/maintenance,
/obj/machinery/atmospherics/pipe/simple/supply/hidden/layer4{
	dir = 8;
	icon_state = "pipe11-4"
	},
/obj/machinery/atmospherics/pipe/simple/scrubbers/hidden/layer2{
	dir = 8;
	icon_state = "pipe11-2"
	},
/turf/open/floor/plating,
/area/ship/maintenance/central)
"av" = (
/obj/structure/cable{
	icon_state = "2-4"
	},
/obj/structure/cable{
	icon_state = "2-8"
	},
/obj/machinery/atmospherics/pipe/manifold/supply/hidden/layer4{
	dir = 1;
	icon_state = "manifold-4"
	},
/obj/machinery/atmospherics/pipe/manifold/scrubbers/hidden/layer2{
	dir = 1;
	icon_state = "manifold-2"
	},
/obj/machinery/light/small/directional/north{
	icon_state = "bulb"
	},
/obj/structure/catwalk/over/plated_catwalk,
/turf/open/floor/plating,
/area/ship/construction)
"aw" = (
/obj/structure/cable{
	icon_state = "4-8"
	},
/obj/machinery/atmospherics/pipe/simple/supply/hidden/layer4{
	dir = 8;
	icon_state = "pipe11-4"
	},
/obj/machinery/atmospherics/pipe/simple/scrubbers/hidden/layer2{
	dir = 8;
	icon_state = "pipe11-2"
	},
/obj/structure/catwalk/over/plated_catwalk,
/obj/machinery/airalarm/directional/north,
/turf/open/floor/plating,
/area/ship/construction)
"ax" = (
/obj/structure/cable{
	icon_state = "1-8"
	},
/obj/machinery/atmospherics/pipe/simple/supply/hidden/layer4{
	dir = 9;
	icon_state = "pipe11-4"
	},
/obj/machinery/atmospherics/pipe/simple/scrubbers/hidden/layer2{
	dir = 9;
	icon_state = "pipe11-2"
	},
/obj/structure/catwalk/over/plated_catwalk,
/turf/open/floor/plating,
/area/ship/construction)
"ay" = (
/obj/structure/window/reinforced/fulltile,
/turf/open/floor/plating,
/area/ship/construction)
"az" = (
/obj/machinery/power/tracker,
/obj/structure/cable{
	icon_state = "0-4"
	},
/turf/open/floor/plating,
/area/ship/external)
"aA" = (
/obj/machinery/power/solar,
/obj/structure/cable{
	icon_state = "0-4"
	},
/obj/structure/cable{
	icon_state = "4-8"
	},
/turf/open/floor/plating,
/area/ship/external)
"aB" = (
/obj/machinery/power/solar,
/obj/structure/cable{
	icon_state = "0-8"
	},
/obj/structure/cable{
	icon_state = "4-8"
	},
/obj/structure/cable{
	icon_state = "2-4"
	},
/turf/open/floor/plating,
/area/ship/external)
"aC" = (
/obj/machinery/power/solar,
/obj/structure/cable{
	icon_state = "0-8"
	},
/obj/structure/cable{
	icon_state = "4-8"
	},
/turf/open/floor/plating,
/area/ship/external)
"aD" = (
/obj/machinery/power/solar,
/obj/structure/cable{
	icon_state = "0-8"
	},
/turf/open/floor/plating,
/area/ship/external)
"aE" = (
/turf/closed/wall,
/area/ship/crew)
"aF" = (
/turf/closed/wall/rust,
/area/ship/crew)
"aG" = (
/turf/closed/wall/rust,
/area/ship/construction)
"aH" = (
/obj/structure/cable{
	icon_state = "1-2"
	},
/obj/machinery/atmospherics/pipe/simple/supply/hidden/layer4,
/obj/machinery/atmospherics/pipe/simple/scrubbers/hidden/layer2,
/obj/structure/catwalk/over/plated_catwalk,
/turf/open/floor/plating,
/area/ship/construction)
"aI" = (
/turf/open/floor/plating/rust,
/area/ship/construction)
"aJ" = (
/obj/machinery/rnd/production/techfab/department/service,
/turf/open/floor/plating,
/area/ship/construction)
"aK" = (
/turf/closed/wall/rust,
/area/ship/cargo)
"aL" = (
/turf/closed/wall,
/area/ship/cargo)
"aM" = (
/obj/machinery/power/solar_control,
/obj/structure/window/reinforced{
	dir = 1;
	icon_state = "rwindow"
	},
/obj/structure/window/reinforced{
	dir = 8;
	icon_state = "rwindow"
	},
/obj/structure/window/reinforced{
	dir = 4;
	icon_state = "rwindow"
	},
/obj/structure/cable{
	icon_state = "0-2"
	},
/obj/structure/cable{
	icon_state = "1-2"
	},
/turf/open/floor/plating,
/area/ship/cargo)
"aN" = (
/obj/structure/closet/cabinet,
/obj/item/storage/belt/grenade/full,
/obj/item/storage/backpack/satchel/sec,
/obj/item/storage/backpack/satchel/leather,
/obj/item/storage/backpack/satchel/tox,
/obj/item/storage/backpack/satchel,
/obj/item/storage/backpack/satchel,
/obj/item/storage/backpack/satchel,
/obj/item/storage/backpack/satchel/cap,
/obj/item/clothing/under/dress/striped,
/obj/item/clothing/under/costume/soviet,
/obj/item/clothing/under/dress/skirt,
/obj/item/clothing/under/misc/assistantformal,
/obj/item/gun/ballistic/shotgun/doublebarrel/improvised/sawn,
/obj/item/reagent_containers/food/snacks/kebab/rat/double,
/turf/open/floor/plating,
/area/ship/crew)
"aO" = (
/obj/machinery/power/apc/auto_name/directional/north,
/obj/structure/cable{
	icon_state = "0-2"
	},
/obj/machinery/atmospherics/pipe/simple/scrubbers/hidden/layer2{
	dir = 6;
	icon_state = "pipe11-2"
	},
/obj/structure/catwalk/over/plated_catwalk,
/turf/open/floor/plating,
/area/ship/crew)
"aP" = (
/obj/structure/bed,
/obj/machinery/atmospherics/components/unary/vent_scrubber/on/layer2{
	dir = 8;
	icon_state = "scrub_map_on-2"
	},
/obj/item/gun/ballistic/automatic/zip_pistol,
/obj/item/bedsheet/random,
/obj/machinery/light/small/directional/east{
	icon_state = "bulb"
	},
/obj/machinery/airalarm/directional/north,
/turf/open/floor/plating,
/area/ship/crew)
"aQ" = (
/obj/structure/table,
/obj/machinery/reagentgrinder{
	pixel_x = 0;
	pixel_y = 21
	},
/obj/item/gun/ballistic/derringer,
/obj/item/gun/ballistic/automatic/zip_pistol{
	pixel_x = 0;
	pixel_y = -13
	},
/obj/item/stack/sheet/metal/twenty,
/obj/item/stack/sheet/metal/twenty,
/obj/item/reagent_containers/food/snacks/burger/rat,
/obj/item/pickaxe/rusted,
/turf/open/floor/plating/rust,
/area/ship/construction)
"aR" = (
/obj/structure/cable{
	icon_state = "1-2"
	},
/obj/machinery/atmospherics/pipe/manifold/supply/hidden/layer4{
	dir = 8;
	icon_state = "manifold-4"
	},
/obj/machinery/atmospherics/pipe/simple/scrubbers/hidden/layer2,
/obj/structure/catwalk/over/plated_catwalk,
/obj/effect/landmark/start/assistant,
/turf/open/floor/plating/rust,
/area/ship/construction)
"aS" = (
/obj/machinery/atmospherics/components/unary/vent_pump/on/layer4{
	dir = 8;
	icon_state = "vent_map_on-4"
	},
/turf/open/floor/plating/rust,
/area/ship/construction)
"aT" = (
/obj/machinery/plate_press,
/obj/machinery/light/small/directional/east{
	icon_state = "bulb"
	},
/turf/open/floor/plating/rust,
/area/ship/construction)
"aU" = (
/obj/machinery/atmospherics/components/unary/portables_connector/layer2{
	dir = 4;
	icon_state = "connector_map-2"
	},
/obj/machinery/portable_atmospherics/canister,
/turf/open/floor/plating,
/area/ship/cargo)
"aV" = (
/obj/machinery/atmospherics/components/binary/pump/layer2{
	dir = 8;
	icon_state = "pump_map-2"
	},
/obj/machinery/light/small/broken/directional/north{
	icon_state = "bulb-broken"
	},
/turf/open/floor/plating/rust,
/area/ship/cargo)
"aW" = (
/obj/machinery/atmospherics/pipe/simple/scrubbers/hidden/layer2{
	dir = 8;
	icon_state = "pipe11-2"
	},
/obj/machinery/airalarm/directional/north,
/turf/open/floor/plating/rust,
/area/ship/cargo)
"aX" = (
/obj/machinery/power/apc/auto_name/directional/north,
/obj/structure/cable{
	icon_state = "0-2"
	},
/obj/machinery/atmospherics/pipe/simple/scrubbers/hidden/layer2{
	dir = 10;
	icon_state = "pipe11-2"
	},
/turf/open/floor/plating,
/area/ship/cargo)
"aY" = (
/obj/machinery/power/port_gen/pacman,
/obj/structure/cable{
	icon_state = "0-4"
	},
/turf/open/floor/plating,
/area/ship/cargo)
"aZ" = (
/obj/structure/cable{
	icon_state = "4-8"
	},
/obj/structure/cable{
	icon_state = "1-4"
	},
/turf/open/floor/plating,
/area/ship/cargo)
"ba" = (
/obj/machinery/power/terminal{
	dir = 4;
	icon_state = "term"
	},
/obj/structure/cable{
	icon_state = "0-8"
	},
/obj/structure/closet/crate,
/obj/item/stack/sheet/mineral/plasma/twenty,
/obj/item/stack/sheet/glass/fifty,
/obj/item/storage/toolbox/mechanical,
/obj/item/storage/toolbox/electrical,
/turf/open/floor/plating,
/area/ship/cargo)
"bb" = (
/obj/machinery/power/smes/engineering,
/obj/structure/cable{
	icon_state = "0-2"
	},
/turf/open/floor/plating,
/area/ship/cargo)
"bc" = (
/obj/machinery/cryopod{
	dir = 4;
	icon_state = "cryopod-open"
	},
/obj/item/reagent_containers/food/snacks/kebab/rat/double,
/obj/machinery/computer/cryopod/directional/west,
/turf/open/floor/plating,
/area/ship/crew)
"bd" = (
/obj/structure/cable{
	icon_state = "1-2"
	},
/obj/machinery/atmospherics/pipe/simple/supply/hidden/layer4{
	dir = 6;
	icon_state = "pipe11-4"
	},
/obj/machinery/atmospherics/pipe/simple/scrubbers/hidden/layer2,
/obj/structure/catwalk/over/plated_catwalk,
/turf/open/floor/plating,
/area/ship/crew)
"be" = (
/obj/structure/bed,
/obj/machinery/atmospherics/components/unary/vent_pump/on/layer4{
	dir = 8;
	icon_state = "vent_map_on-4"
	},
/obj/item/bedsheet/random,
/obj/item/reagent_containers/food/snacks/burger/rat,
/turf/open/floor/plating,
/area/ship/crew)
"bf" = (
/obj/structure/table,
/obj/item/storage/belt/fannypack/black,
/obj/item/storage/belt/military/snack,
/obj/item/gun/ballistic/shotgun/doublebarrel/improvised,
/obj/machinery/light/small/broken/directional/west{
	icon_state = "bulb-broken"
	},
/turf/open/floor/plating,
/area/ship/construction)
"bg" = (
/obj/structure/cable{
	icon_state = "1-2"
	},
/obj/structure/cable{
	icon_state = "2-4"
	},
/obj/machinery/atmospherics/pipe/simple/supply/hidden/layer4,
/obj/machinery/atmospherics/pipe/manifold/scrubbers/hidden/layer2{
	dir = 8;
	icon_state = "manifold-2"
	},
/obj/structure/catwalk/over/plated_catwalk,
/turf/open/floor/plating,
/area/ship/construction)
"bh" = (
/obj/machinery/power/apc/auto_name/directional/south,
/obj/structure/cable{
	icon_state = "0-8"
	},
/obj/machinery/atmospherics/components/unary/vent_scrubber/on/layer2{
	dir = 8;
	icon_state = "scrub_map_on-2"
	},
/obj/item/storage/bag/ore,
/turf/open/floor/plating,
/area/ship/construction)
"bi" = (
/obj/machinery/mineral/mint,
/turf/open/floor/plating/rust,
/area/ship/construction)
"bj" = (
/obj/machinery/autolathe/hacked,
/turf/open/floor/plating,
/area/ship/cargo)
"bk" = (
/turf/open/floor/plating,
/area/ship/cargo)
"bl" = (
/obj/machinery/atmospherics/components/unary/vent_pump/on/layer4,
/turf/open/floor/plating/rust,
/area/ship/cargo)
"bm" = (
/obj/structure/cable{
	icon_state = "1-2"
	},
/obj/machinery/atmospherics/pipe/simple/scrubbers/hidden/layer2,
/turf/open/floor/plating,
/area/ship/cargo)
"bn" = (
/obj/machinery/atmospherics/components/unary/vent_scrubber/on/layer2,
/turf/open/floor/plating,
/area/ship/cargo)
"bo" = (
/obj/structure/cable{
	icon_state = "1-2"
	},
/turf/open/floor/plating,
/area/ship/cargo)
"bp" = (
/obj/structure/cable{
	icon_state = "1-2"
	},
/obj/structure/mineral_door/wood,
/obj/machinery/atmospherics/pipe/simple/supply/hidden/layer4,
/obj/machinery/atmospherics/pipe/simple/scrubbers/hidden/layer2,
/obj/structure/catwalk/over/plated_catwalk,
/turf/open/floor/plating,
/area/ship/crew)
"bq" = (
/turf/closed/wall,
/area/ship/storage)
"br" = (
/obj/structure/cable{
	icon_state = "1-2"
	},
/obj/structure/mineral_door/wood,
/obj/machinery/atmospherics/pipe/simple/supply/hidden/layer4,
/obj/machinery/atmospherics/pipe/simple/scrubbers/hidden/layer2,
/obj/structure/catwalk/over/plated_catwalk,
/turf/open/floor/plating,
/area/ship/storage)
"bs" = (
/turf/closed/wall/rust,
/area/ship/storage)
"bt" = (
/obj/machinery/power/shuttle/engine/electric{
	dir = 4;
	icon_state = "burst"
	},
/obj/structure/window/reinforced,
/obj/structure/window/reinforced{
	dir = 1;
	icon_state = "rwindow"
	},
/obj/structure/window/reinforced{
	dir = 4;
	icon_state = "rwindow"
	},
/obj/structure/cable{
	icon_state = "0-4"
	},
/turf/open/floor/plating,
/area/ship/cargo)
"bu" = (
/obj/machinery/power/smes/shuttle/precharged{
	dir = 4;
	icon_state = "smes"
	},
/obj/structure/window/reinforced,
/obj/structure/window/reinforced{
	dir = 1;
	icon_state = "rwindow"
	},
/obj/structure/window/reinforced{
	dir = 8;
	icon_state = "rwindow"
	},
/obj/structure/cable{
	icon_state = "0-8"
	},
/turf/open/floor/plating,
/area/ship/cargo)
"bv" = (
/obj/machinery/power/terminal{
	dir = 8;
	icon_state = "term"
	},
/obj/structure/cable{
	icon_state = "0-4"
	},
/obj/structure/catwalk/over/plated_catwalk,
/turf/open/floor/plating,
/area/ship/cargo)
"bw" = (
/obj/structure/cable{
	icon_state = "4-8"
	},
/obj/machinery/atmospherics/pipe/simple/supply/hidden/layer4{
	dir = 5;
	icon_state = "pipe11-4"
	},
/obj/structure/catwalk/over/plated_catwalk,
/turf/open/floor/plating/rust,
/area/ship/cargo)
"bx" = (
/obj/structure/cable{
	icon_state = "4-8"
	},
/obj/structure/cable{
	icon_state = "1-4"
	},
/obj/machinery/atmospherics/pipe/manifold/supply/hidden/layer4{
	dir = 1;
	icon_state = "manifold-4"
	},
/obj/machinery/atmospherics/pipe/manifold/scrubbers/hidden/layer2{
	dir = 8;
	icon_state = "manifold-2"
	},
/obj/structure/catwalk/over/plated_catwalk,
/turf/open/floor/plating,
/area/ship/cargo)
"by" = (
/obj/structure/cable{
	icon_state = "4-8"
	},
/obj/structure/cable{
	icon_state = "2-4"
	},
/obj/machinery/atmospherics/pipe/manifold4w/supply/hidden/layer4,
/obj/machinery/atmospherics/pipe/manifold/scrubbers/hidden/layer2{
	dir = 1;
	icon_state = "manifold-2"
	},
/obj/structure/catwalk/over/plated_catwalk,
/turf/open/floor/plating,
/area/ship/cargo)
"bz" = (
/obj/structure/cable{
	icon_state = "4-8"
	},
/obj/machinery/atmospherics/pipe/simple/supply/hidden/layer4{
	dir = 8;
	icon_state = "pipe11-4"
	},
/obj/machinery/atmospherics/pipe/manifold/scrubbers/hidden/layer2,
/obj/structure/catwalk/over/plated_catwalk,
/obj/effect/landmark/start/assistant,
/turf/open/floor/plating/rust,
/area/ship/cargo)
"bA" = (
/obj/structure/cable{
	icon_state = "4-8"
	},
/obj/machinery/atmospherics/pipe/simple/supply/hidden/layer4{
	dir = 8;
	icon_state = "pipe11-4"
	},
/obj/machinery/atmospherics/pipe/simple/scrubbers/hidden/layer2{
	dir = 8;
	icon_state = "pipe11-2"
	},
/obj/structure/catwalk/over/plated_catwalk,
/turf/open/floor/plating/rust,
/area/ship/cargo)
"bB" = (
/obj/structure/cable{
	icon_state = "1-8"
	},
/obj/structure/cable{
	icon_state = "1-4"
	},
/obj/machinery/atmospherics/pipe/simple/supply/hidden/layer4{
	dir = 8;
	icon_state = "pipe11-4"
	},
/obj/machinery/atmospherics/pipe/manifold/scrubbers/hidden/layer2{
	dir = 1;
	icon_state = "manifold-2"
	},
/obj/structure/catwalk/over/plated_catwalk,
/turf/open/floor/plating/rust,
/area/ship/cargo)
"bC" = (
/obj/structure/cable{
	icon_state = "4-8"
	},
/obj/machinery/door/airlock/maintenance/glass,
/obj/machinery/atmospherics/pipe/simple/supply/hidden/layer4{
	dir = 8;
	icon_state = "pipe11-4"
	},
/obj/machinery/atmospherics/pipe/simple/scrubbers/hidden/layer2{
	dir = 8;
	icon_state = "pipe11-2"
	},
/obj/structure/catwalk/over/plated_catwalk,
/turf/open/floor/plating,
/area/ship/cargo)
"bD" = (
/obj/structure/cable{
	icon_state = "4-8"
	},
/obj/machinery/atmospherics/pipe/simple/supply/hidden/layer4{
	dir = 8;
	icon_state = "pipe11-4"
	},
/obj/machinery/atmospherics/pipe/manifold/scrubbers/hidden/layer2{
	dir = 1;
	icon_state = "manifold-2"
	},
/obj/structure/catwalk/over/plated_catwalk,
/obj/machinery/airalarm/directional/north,
/turf/open/floor/plating,
/area/ship/storage)
"bE" = (
/obj/structure/cable{
	icon_state = "4-8"
	},
/obj/structure/cable{
	icon_state = "1-8"
	},
/obj/machinery/atmospherics/pipe/manifold4w/supply/hidden/layer4,
/obj/machinery/atmospherics/pipe/manifold/scrubbers/hidden/layer2,
/obj/structure/catwalk/over/plated_catwalk,
/turf/open/floor/plating,
/area/ship/storage)
"bF" = (
/obj/structure/cable{
	icon_state = "4-8"
	},
/obj/structure/cable{
	icon_state = "2-8"
	},
/obj/machinery/atmospherics/pipe/simple/supply/hidden/layer4{
	dir = 8;
	icon_state = "pipe11-4"
	},
/obj/machinery/atmospherics/pipe/simple/scrubbers/hidden/layer2{
	dir = 8;
	icon_state = "pipe11-2"
	},
/obj/structure/catwalk/over/plated_catwalk,
/turf/open/floor/plating,
/area/ship/storage)
"bG" = (
/obj/machinery/power/apc/auto_name/directional/north,
/obj/structure/cable{
	icon_state = "0-8"
	},
/obj/machinery/atmospherics/pipe/simple/supply/hidden/layer4{
	dir = 8;
	icon_state = "pipe11-4"
	},
/obj/machinery/atmospherics/pipe/manifold/scrubbers/hidden/layer2{
	dir = 1;
	icon_state = "manifold-2"
	},
/obj/structure/catwalk/over/plated_catwalk,
/turf/open/floor/plating,
/area/ship/storage)
"bH" = (
/obj/structure/noticeboard{
	pixel_y = 30
	},
/obj/machinery/atmospherics/pipe/simple/supply/hidden/layer4{
	dir = 8;
	icon_state = "pipe11-4"
	},
/obj/machinery/atmospherics/pipe/simple/scrubbers/hidden/layer2{
	dir = 8;
	icon_state = "pipe11-2"
	},
/obj/structure/catwalk/over/plated_catwalk,
/turf/open/floor/plating,
/area/ship/storage)
"bI" = (
/obj/structure/cable{
	icon_state = "1-2"
	},
/obj/machinery/atmospherics/pipe/manifold/supply/hidden/layer4{
	dir = 4;
	icon_state = "manifold-4"
	},
/obj/machinery/atmospherics/pipe/simple/scrubbers/hidden/layer2{
	dir = 9;
	icon_state = "pipe11-2"
	},
/obj/structure/catwalk/over/plated_catwalk,
/turf/open/floor/plating,
/area/ship/storage)
"bJ" = (
/obj/machinery/processor,
/obj/machinery/light/small/directional/north{
	icon_state = "bulb"
	},
/turf/open/floor/plating/rust,
/area/ship/storage)
"bK" = (
/obj/machinery/atmospherics/components/unary/portables_connector/layer4{
	dir = 4;
	icon_state = "connector_map-4"
	},
/obj/machinery/portable_atmospherics/canister/air,
/turf/open/floor/plating,
/area/ship/cargo)
"bL" = (
/obj/machinery/atmospherics/components/binary/pump/layer4{
	dir = 4;
	icon_state = "pump_map-4"
	},
/obj/machinery/portable_atmospherics/canister/air,
/turf/open/floor/plating,
/area/ship/cargo)
"bM" = (
/obj/machinery/atmospherics/pipe/simple/supply/hidden/layer4{
	dir = 8;
	icon_state = "pipe11-4"
	},
/turf/open/floor/plating/rust,
/area/ship/cargo)
"bN" = (
/obj/machinery/atmospherics/pipe/simple/supply/hidden/layer4{
	dir = 9;
	icon_state = "pipe11-4"
	},
/obj/machinery/atmospherics/components/unary/vent_scrubber/on/layer2{
	dir = 1;
	icon_state = "scrub_map_on-2"
	},
/obj/machinery/light/small/directional/south,
/turf/open/floor/plating,
/area/ship/cargo)
"bO" = (
/obj/structure/cable{
	icon_state = "1-2"
	},
/obj/machinery/atmospherics/pipe/simple/supply/hidden/layer4,
/obj/machinery/atmospherics/pipe/simple/scrubbers/hidden/layer2,
/obj/structure/catwalk/over/plated_catwalk,
/turf/open/floor/plating,
/area/ship/cargo)
"bP" = (
/obj/machinery/mineral/ore_redemption{
	dir = 8;
	icon_state = "ore_redemption"
	},
/turf/open/floor/plating,
/area/ship/cargo)
"bQ" = (
/obj/structure/ore_box,
/obj/machinery/button/door{
	dir = 1;
	icon_state = "doorctrl";
	id = 44411;
	pixel_y = -28
	},
/turf/open/floor/plating,
/area/ship/cargo)
"bR" = (
/obj/machinery/atmospherics/pipe/layer_manifold,
/obj/machinery/light/small/directional/east{
	icon_state = "bulb"
	},
/turf/open/floor/plating/rust,
/area/ship/cargo)
"bS" = (
/obj/machinery/atmospherics/components/unary/vent_scrubber/on/layer2{
	dir = 1;
	icon_state = "scrub_map_on-2"
	},
/obj/machinery/light/small/broken/directional/west{
	icon_state = "bulb-broken"
	},
/turf/open/floor/plating,
/area/ship/storage)
"bT" = (
/obj/machinery/atmospherics/components/unary/vent_pump/on/layer4{
	dir = 1;
	icon_state = "vent_map_on-4"
	},
/turf/open/floor/plating/rust,
/area/ship/storage)
"bU" = (
/obj/structure/cable{
	icon_state = "1-4"
	},
/turf/open/floor/plating/rust,
/area/ship/storage)
"bV" = (
/obj/structure/cable{
	icon_state = "4-8"
	},
/obj/machinery/atmospherics/components/unary/vent_scrubber/on/layer2{
	dir = 1;
	icon_state = "scrub_map_on-2"
	},
/obj/effect/landmark/start/assistant,
/turf/open/floor/plating,
/area/ship/storage)
"bW" = (
/obj/structure/cable{
	icon_state = "4-8"
	},
/turf/open/floor/plating,
/area/ship/storage)
"bX" = (
/obj/structure/cable{
	icon_state = "1-8"
	},
/obj/machinery/atmospherics/components/unary/vent_pump/on/layer4{
	dir = 1;
	icon_state = "vent_map_on-4"
	},
/turf/open/floor/plating,
/area/ship/storage)
"bY" = (
/turf/open/floor/plating,
/area/ship/storage)
"bZ" = (
/obj/structure/plasticflaps,
/obj/machinery/mineral/unloading_machine,
/turf/open/floor/plating,
/area/ship/storage)
"ca" = (
/obj/structure/cable{
	icon_state = "1-2"
	},
/obj/structure/mineral_door/wood,
/obj/machinery/atmospherics/pipe/simple/supply/hidden/layer4,
/obj/machinery/atmospherics/pipe/simple/scrubbers/hidden/layer2,
/obj/structure/catwalk/over/plated_catwalk,
/turf/open/floor/plating,
/area/ship/maintenance)
"cb" = (
/obj/machinery/door/window,
/obj/machinery/door/window{
	dir = 1;
	icon_state = "left"
	},
/obj/machinery/door/poddoor/shutters{
	id = 44411
	},
/obj/machinery/atmospherics/pipe/simple/scrubbers/hidden/layer4,
/obj/machinery/atmospherics/pipe/simple/scrubbers/hidden,
/obj/machinery/atmospherics/components/unary/vent_scrubber/on/layer2{
	dir = 1;
	icon_state = "scrub_map_on-2"
	},
/turf/open/floor/plating,
/area/ship/cargo)
"cc" = (
/obj/machinery/suit_storage_unit/inherit,
/obj/item/clothing/suit/hooded/survivor,
/obj/item/tank/internals/oxygen{
	pixel_y = 0
	},
/turf/open/floor/plating/rust,
/area/ship/storage)
"cd" = (
/obj/structure/closet/cardboard,
/obj/item/storage/belt/military/army,
/obj/item/clothing/under/dress/blacktango,
/obj/item/clothing/under/dress/redeveninggown,
/obj/item/clothing/under/costume/russian_officer,
/obj/item/clothing/under/costume/lobster,
/obj/item/clothing/under/costume/soviet,
/obj/item/clothing/under/costume/soviet,
/obj/machinery/light/small/directional/east{
	icon_state = "bulb"
	},
/obj/item/reagent_containers/food/snacks/kebab/rat/double,
/obj/item/pickaxe/rusted,
/turf/open/floor/plating/rust,
/area/ship/storage)
"ce" = (
/turf/closed/wall,
/area/ship/maintenance)
"cf" = (
/obj/structure/fermenting_barrel,
/obj/machinery/light/small/broken/directional/north{
	icon_state = "bulb-broken"
	},
/turf/open/floor/plating,
/area/ship/maintenance)
"cg" = (
/obj/machinery/power/apc/auto_name/directional/north,
/obj/structure/cable{
	icon_state = "0-4"
	},
/obj/item/reagent_containers/food/snacks/burger/rat,
/turf/open/floor/plating,
/area/ship/maintenance)
"ch" = (
/obj/structure/cable{
	icon_state = "4-8"
	},
/obj/machinery/atmospherics/components/unary/vent_scrubber/on/layer2{
	dir = 4;
	icon_state = "scrub_map_on-2"
	},
/obj/machinery/airalarm/directional/north,
/turf/open/floor/plating,
/area/ship/maintenance)
"ci" = (
/obj/structure/cable{
	icon_state = "1-8"
	},
/obj/machinery/atmospherics/pipe/simple/supply/hidden/layer4{
	dir = 5;
	icon_state = "pipe11-4"
	},
/obj/machinery/atmospherics/pipe/simple/scrubbers/hidden/layer2{
	dir = 9;
	icon_state = "pipe11-2"
	},
/obj/structure/catwalk/over/plated_catwalk,
/turf/open/floor/plating,
/area/ship/maintenance)
"cj" = (
/obj/structure/mirror{
	pixel_y = 28
	},
/obj/machinery/atmospherics/components/unary/vent_pump/on/layer4{
	dir = 8;
	icon_state = "vent_map_on-4"
	},
/turf/open/floor/plating,
/area/ship/maintenance)
"ck" = (
/obj/machinery/door/window,
/obj/machinery/door/window{
	dir = 1;
	icon_state = "left"
	},
/obj/machinery/door/poddoor/shutters{
	id = 44411
	},
/obj/machinery/atmospherics/components/unary/vent_scrubber/on/layer3{
	dir = 1;
	icon_state = "scrub_map_on-3"
	},
/obj/machinery/atmospherics/pipe/simple/scrubbers/hidden/layer4,
/turf/open/floor/plating,
/area/ship/cargo)
"cl" = (
/obj/structure/window/reinforced/fulltile,
/turf/open/floor/plating,
/area/ship/storage)
"cm" = (
/turf/closed/wall/rust,
/area/ship/maintenance)
"cn" = (
/obj/structure/closet/cardboard,
/obj/item/clothing/under/costume/redcoat,
/obj/item/clothing/under/costume/redcoat,
/obj/item/clothing/under/costume/maid,
/obj/item/gun/ballistic/shotgun/doublebarrel/hook,
/obj/item/gun/ballistic/shotgun/doublebarrel/improvised,
/obj/item/storage/toolbox/electrical,
/obj/item/reagent_containers/food/snacks/kebab/rat/double,
/turf/open/floor/plating,
/area/ship/maintenance)
"co" = (
/turf/open/floor/plating,
/area/ship/maintenance)
"cp" = (
/turf/open/floor/plating/rust,
/area/ship/maintenance)
"cq" = (
/obj/structure/bonfire,
/turf/open/floor/plating,
/area/ship/maintenance)
"cr" = (
/obj/machinery/door/window,
/obj/machinery/door/window{
	dir = 1;
	icon_state = "left"
	},
/obj/machinery/door/poddoor/shutters{
	id = 44411
	},
/obj/machinery/atmospherics/components/unary/vent_scrubber/on/layer4{
	dir = 1;
	icon_state = "scrub_map_on-4"
	},
/obj/machinery/light/small/directional/east{
	icon_state = "bulb"
	},
/obj/docking_port/mobile{
	dir = 2;
	icon_state = "pinonclose"
	},
/turf/open/floor/plating,
/area/ship/cargo)
"cs" = (
/obj/structure/closet/cardboard,
/obj/item/storage/belt/utility/full,
/obj/item/storage/belt/utility/atmostech,
/obj/item/gun/ballistic/automatic/zip_pistol,
/obj/item/gun/ballistic/shotgun/doublebarrel,
/obj/item/gun/ballistic/shotgun/doublebarrel/improvised/sawn,
/turf/open/floor/plating,
/area/ship/maintenance)
"ct" = (
/obj/machinery/light/small/directional/south,
/turf/open/floor/plating,
/area/ship/maintenance)
"cu" = (
/obj/structure/window/reinforced/fulltile,
/turf/open/floor/plating,
/area/ship/maintenance)
"cv" = (
/obj/effect/landmark/start/assistant,
/turf/open/floor/plating,
/area/ship/maintenance)
"cw" = (
/obj/machinery/autolathe/hacked,
/turf/open/floor/plating,
/area/ship/storage)

(1,1,1) = {"
aa
aa
aa
aa
aa
az
aK
aL
aL
bt
aL
aL
aa
aa
aa
aa
aa
aa
aa
"}
(2,1,1) = {"
aa
aa
aa
aa
aa
aA
aK
aU
bj
bu
bK
aL
ce
cm
cm
ce
aa
aa
aa
"}
(3,1,1) = {"
aa
aa
aa
aa
aa
aA
aK
aV
bk
bv
bL
aL
cf
cn
cs
cu
aa
aa
aa
"}
(4,1,1) = {"
aa
aa
aa
aa
aa
aA
aK
aW
bl
bw
bM
aL
cg
co
cv
cu
aa
aa
aa
"}
(5,1,1) = {"
aa
aa
aa
aa
aa
aA
aK
aX
bm
bx
bN
aL
ch
cp
cp
ce
aa
aa
aa
"}
(6,1,1) = {"
aa
aa
aa
aa
aa
aA
aL
aY
bl
by
bO
ca
ci
cq
cp
ce
aa
aa
aa
"}
(7,1,1) = {"
aa
aa
aa
aa
aa
aB
aM
aZ
bn
bz
bP
aK
cj
co
ct
ce
aa
aa
aa
"}
(8,1,1) = {"
aa
aa
aa
aa
aa
aC
aL
ba
bk
bA
bQ
aK
aK
aL
ce
ce
aa
aa
aa
"}
(9,1,1) = {"
aa
aa
aa
aa
aa
aD
aL
bb
bo
bB
bR
cb
ck
cr
aa
aa
aa
aa
aa
"}
(10,1,1) = {"
aa
aa
aa
aa
aa
aE
aL
aL
aK
bC
aL
aL
aL
aL
aa
aa
aa
aa
aa
"}
(11,1,1) = {"
aa
aa
aa
ad
aq
aE
aN
bc
aE
bD
bS
bY
cl
aa
aa
aa
aa
aa
aa
"}
(12,1,1) = {"
aa
aa
ah
ah
ar
aF
aO
bd
bp
bE
bT
cw
cl
aa
aa
aa
aa
aa
aa
"}
(13,1,1) = {"
aa
ad
ah
an
as
aF
aP
be
aE
bF
bU
cc
bs
aa
aa
aa
aa
aa
aa
"}
(14,1,1) = {"
aa
ad
ai
ao
at
aF
aF
aE
aE
bG
bV
cc
bs
aa
aa
aa
aa
aa
aa
"}
(15,1,1) = {"
ab
ab
aj
aj
au
aG
aQ
bf
bq
bH
bW
cd
bs
aa
aa
aa
aa
aa
aa
"}
(16,1,1) = {"
ab
ae
ak
aj
av
aH
aR
bg
br
bI
bX
bq
bq
aa
aa
aa
aa
aa
aa
"}
(17,1,1) = {"
ac
af
al
aj
aw
aI
aS
bh
bs
bJ
bY
bq
aa
aa
aa
aa
aa
aa
aa
"}
(18,1,1) = {"
ab
ag
am
ap
ax
aJ
aT
bi
bs
bs
bZ
bq
aa
aa
aa
aa
aa
aa
aa
"}
(19,1,1) = {"
ab
ab
ab
ab
ay
aG
aG
aG
bq
bq
aa
aa
aa
aa
aa
aa
aa
aa
aa
"}
