//MAP CONVERTED BY dmm2tgm.py THIS HEADER COMMENT PREVENTS RECONVERSION, DO NOT REMOVE
"a" = (
/turf/template_noop,
/area/template_noop)
"b" = (
/obj/structure/sign/minutemen,
/turf/closed/wall/mineral/plastitanium/nodiagonal,
/area/ship/bridge)
"c" = (
/obj/structure/fans/tiny,
/obj/machinery/door/poddoor{
	id = 161121;
	name = "exit door"
	},
/turf/open/floor/plasteel/tech/techmaint,
/area/ship/bridge)
"d" = (
/turf/closed/wall/mineral/plastitanium/nodiagonal,
/area/ship/bridge)
"e" = (
/turf/open/floor/plasteel/tech/techmaint,
/area/ship/bridge)
"f" = (
/obj/machinery/button/door{
	name = "exit button";
	pixel_x = 32;
	id = 161121
	},
/turf/open/floor/plasteel/tech/techmaint,
/area/ship/bridge)
"g" = (
/obj/machinery/power/shuttle/engine/electric{
	dir = 4
	},
/turf/open/floor/plating,
/area/ship/bridge)
"h" = (
/obj/machinery/power/smes/shuttle/precharged{
	dir = 4
	},
/obj/structure/window/reinforced{
	icon_state = "rwindow";
	dir = 8
	},
/turf/open/floor/plasteel/mono/white,
/area/ship/bridge)
"i" = (
/obj/machinery/power/terminal{
	dir = 8
	},
/obj/structure/cable{
	icon_state = "0-4"
	},
/turf/open/floor/plasteel/white,
/area/ship/bridge)
"j" = (
/obj/structure/cable{
	icon_state = "2-8"
	},
/turf/open/floor/plasteel/white,
/area/ship/bridge)
"k" = (
/obj/machinery/sleeper,
/turf/open/floor/plasteel/white,
/area/ship/bridge)
"l" = (
/obj/structure/rack,
/obj/item/clothing/mask/surgical,
/obj/item/clothing/mask/surgical,
/obj/item/storage/bag/medical,
/obj/item/storage/belt/medical,
/obj/item/storage/firstaid/medical,
/obj/item/storage/firstaid/fire,
/obj/item/storage/firstaid/brute,
/obj/item/storage/firstaid/advanced,
/obj/item/storage/firstaid/advanced,
/obj/item/storage/firstaid/advanced,
/obj/item/storage/firstaid/advanced,
/obj/item/storage/firstaid/regular,
/obj/item/storage/firstaid/o2,
/obj/item/storage/firstaid/toxin,
/obj/item/pickaxe/emergency,
/obj/item/storage/bag/ore,
/obj/machinery/power/terminal{
	icon_state = "term";
	dir = 4
	},
/obj/structure/cable{
	icon_state = "0-2"
	},
/obj/item/stack/sheet/metal/fifty,
/obj/item/stack/sheet/glass/fifty,
/obj/item/storage/firstaid/tactical,
/obj/item/storage/firstaid/tactical,
/turf/open/floor/plasteel/white,
/area/ship/bridge)
"m" = (
/obj/machinery/power/smes,
/obj/structure/cable{
	icon_state = "0-2"
	},
/obj/item/radio/intercom/wideband/directional/north,
/turf/open/floor/plasteel/white,
/area/ship/bridge)
"n" = (
/obj/effect/spawner/structure/window/plasma/reinforced/plastitanium,
/obj/machinery/door/poddoor{
	dir = 4;
	id = 135135;
	name = "window door"
	},
/turf/open/floor/plating,
/area/ship/bridge)
"o" = (
/obj/machinery/suit_storage_unit/inherit,
/obj/item/clothing/suit/space/hardsuit/security/independent/minutemen,
/obj/item/tank/jetpack,
/turf/open/floor/plasteel/white,
/area/ship/bridge)
"p" = (
/obj/structure/cable{
	icon_state = "2-4"
	},
/obj/structure/cable{
	icon_state = "1-4"
	},
/turf/open/floor/plasteel/white,
/area/ship/bridge)
"q" = (
/obj/structure/cable{
	icon_state = "4-8"
	},
/obj/effect/turf_decal/corner/opaque/blue,
/obj/effect/turf_decal/corner/opaque/blue{
	icon_state = "corner_white";
	dir = 8
	},
/obj/effect/turf_decal/corner/opaque/blue{
	icon_state = "corner_white";
	dir = 4
	},
/turf/open/floor/plasteel/white,
/area/ship/bridge)
"r" = (
/obj/structure/cable{
	icon_state = "1-2"
	},
/obj/structure/cable{
	icon_state = "4-8"
	},
/obj/effect/turf_decal/corner/opaque/blue{
	icon_state = "corner_white";
	dir = 8
	},
/obj/effect/turf_decal/corner/opaque/blue,
/obj/effect/turf_decal/corner/opaque/blue{
	icon_state = "corner_white";
	dir = 1
	},
/turf/open/floor/plasteel/white,
/area/ship/bridge)
"s" = (
/obj/structure/cable{
	icon_state = "1-8"
	},
/obj/structure/cable{
	icon_state = "1-2"
	},
/turf/open/floor/plasteel/white,
/area/ship/bridge)
"t" = (
/obj/item/stack/medical/bruise_pack,
/obj/item/stack/medical/bruise_pack,
/obj/item/stack/medical/gauze/twelve,
/obj/item/stack/medical/gauze/twelve,
/obj/item/stack/medical/gauze/twelve,
/obj/item/stack/medical/mesh/advanced,
/obj/item/stack/medical/mesh/advanced,
/obj/item/stack/medical/mesh/advanced,
/obj/item/stack/medical/mesh/advanced,
/obj/item/stack/medical/ointment,
/obj/item/stack/medical/ointment,
/obj/item/stack/medical/ointment,
/obj/item/stack/medical/ointment,
/obj/item/stack/medical/suture/medicated,
/obj/item/stack/medical/suture/medicated,
/obj/item/stack/medical/suture/medicated,
/obj/item/stack/medical/suture/medicated,
/obj/item/stack/medical/suture/medicated,
/obj/item/stack/medical/suture/medicated,
/obj/item/stack/medical/splint,
/obj/item/stack/medical/splint,
/obj/item/stack/medical/splint,
/obj/structure/window/reinforced{
	icon_state = "rwindow";
	dir = 8
	},
/obj/structure/closet/wall/white/med{
	pixel_y = 31
	},
/obj/machinery/autolathe,
/turf/open/floor/plasteel/tech/techmaint,
/area/ship/bridge)
"u" = (
/obj/machinery/power/apc/auto_name/directional/north,
/obj/structure/cable{
	icon_state = "0-2"
	},
/turf/open/floor/plasteel/mono/white,
/area/ship/bridge)
"v" = (
/obj/machinery/computer/helm{
	dir = 8
	},
/turf/open/floor/plasteel/mono/white,
/area/ship/bridge)
"w" = (
/obj/machinery/vending/medical,
/turf/open/floor/plasteel/white,
/area/ship/bridge)
"x" = (
/obj/structure/cable{
	icon_state = "1-2"
	},
/turf/open/floor/plasteel/white,
/area/ship/bridge)
"y" = (
/obj/effect/turf_decal/corner/opaque/blue{
	icon_state = "corner_white";
	dir = 4
	},
/obj/effect/turf_decal/corner/opaque/blue,
/obj/effect/turf_decal/corner/opaque/blue{
	icon_state = "corner_white";
	dir = 1
	},
/turf/open/floor/plasteel/white,
/area/ship/bridge)
"z" = (
/obj/structure/cable{
	icon_state = "1-4"
	},
/turf/open/floor/plasteel/white,
/area/ship/bridge)
"A" = (
/obj/machinery/door/window/brigdoor/westleft,
/obj/structure/cable{
	icon_state = "4-8"
	},
/obj/machinery/button/door{
	name = "window button";
	pixel_y = -28;
	id = 135135
	},
/turf/open/floor/plasteel/tech/techmaint,
/area/ship/bridge)
"B" = (
/obj/item/autosurgeon,
/obj/item/autosurgeon/syndicate/anti_stun,
/obj/item/clothing/under/rank/medical/paramedic,
/obj/item/clothing/under/rank/medical/paramedic/skirt,
/obj/item/door_remote/chief_medical_officer,
/obj/item/reagent_containers/spray/rhigoxane,
/obj/item/reagent_containers/spray/rhigoxane,
/obj/item/storage/backpack/ert/medical,
/obj/item/scalpel/advanced,
/obj/item/radio,
/obj/item/retractor/advanced,
/obj/item/surgicaldrill/advanced,
/obj/item/healthanalyzer/advanced,
/obj/structure/closet/wall/white/med{
	icon_state = "freezer_wall";
	dir = 1;
	pixel_y = -31
	},
/obj/item/clothing/mask/gas/sechailer/minutemen,
/obj/item/storage/belt/military/minutemen,
/obj/item/clothing/under/rank/security/officer/minutemen,
/obj/structure/cable{
	icon_state = "1-8"
	},
/obj/item/gun/ballistic/automatic/smg/c20r/unrestricted,
/obj/item/ammo_box/magazine/smgm45,
/obj/item/ammo_box/magazine/smgm45,
/obj/item/ammo_box/magazine/smgm45,
/obj/item/clothing/shoes/combat/swat,
/obj/item/clothing/gloves/krav_maga/combatglovesplus,
/obj/item/clothing/head/helmet/marine/medic,
/obj/item/clothing/suit/armor/vest/marine,
/turf/open/floor/plasteel/mono/white,
/area/ship/bridge)
"C" = (
/obj/machinery/computer/cryopod/directional/south,
/obj/machinery/cryopod{
	icon_state = "cryopod-open";
	dir = 8
	},
/turf/open/floor/plasteel/mono/white,
/area/ship/bridge)
"D" = (
/obj/structure/cable{
	icon_state = "1-8"
	},
/turf/open/floor/plasteel/white,
/area/ship/bridge)
"E" = (
/obj/machinery/computer/operating{
	icon_state = "computer";
	dir = 1
	},
/turf/open/floor/plasteel/white,
/area/ship/bridge)
"F" = (
/obj/machinery/stasis,
/obj/machinery/defibrillator_mount/charging{
	pixel_y = -29
	},
/obj/structure/cable{
	icon_state = "1-4"
	},
/turf/open/floor/plasteel/white,
/area/ship/bridge)
"G" = (
/obj/machinery/power/port_gen/pacman,
/obj/structure/cable{
	icon_state = "0-8"
	},
/turf/open/floor/plasteel/white,
/area/ship/bridge)
"H" = (
/obj/structure/fans/tiny,
/obj/machinery/door/poddoor{
	id = 161121;
	name = "exit door"
	},
/obj/docking_port/mobile{
	can_move_docking_ports = 1;
	dir = 2;
	launch_status = 0;
	port_direction = 8;
	preferred_direction = 4
	},
/turf/open/floor/plasteel/tech/techmaint,
/area/ship/bridge)
"I" = (
/obj/structure/cable{
	icon_state = "1-2"
	},
/obj/effect/turf_decal/corner/opaque/blue{
	icon_state = "corner_white";
	dir = 1
	},
/obj/effect/turf_decal/corner/opaque/blue{
	icon_state = "corner_white";
	dir = 4
	},
/obj/effect/turf_decal/corner/opaque/blue{
	icon_state = "corner_white";
	dir = 8
	},
/turf/open/floor/plasteel/white,
/area/ship/bridge)

(1,1,1) = {"
a
a
g
a
a
g
a
a
"}
(2,1,1) = {"
b
d
h
d
d
h
d
b
"}
(3,1,1) = {"
H
e
i
o
w
i
e
c
"}
(4,1,1) = {"
c
f
j
p
x
D
f
c
"}
(5,1,1) = {"
d
d
k
q
y
E
d
d
"}
(6,1,1) = {"
a
d
l
r
I
F
d
a
"}
(7,1,1) = {"
a
d
m
s
z
G
d
a
"}
(8,1,1) = {"
a
b
d
t
A
d
b
a
"}
(9,1,1) = {"
a
a
d
u
B
d
a
a
"}
(10,1,1) = {"
a
a
n
v
C
d
a
a
"}
(11,1,1) = {"
a
a
n
n
n
d
a
a
"}
