//MAP CONVERTED BY dmm2tgm.py THIS HEADER COMMENT PREVENTS RECONVERSION, DO NOT REMOVE
"aa" = (
/turf/template_noop,
/area/template_noop)
"ab" = (
/turf/open/floor/plating,
/area/ship/external)
"ac" = (
/obj/machinery/atmospherics/components/unary/outlet_injector,
/turf/open/floor/plating,
/area/ship/external)
"ad" = (
/turf/closed/wall/mineral/plastitanium,
/area/ship/external)
"ae" = (
/turf/closed/wall/mineral/plastitanium,
/area/ship/cargo)
"af" = (
/obj/machinery/door/poddoor,
/obj/machinery/atmospherics/pipe/simple/scrubbers,
/obj/structure/fans/tiny,
/turf/open/floor/plasteel/tech/grid,
/area/ship/cargo)
"ag" = (
/obj/machinery/door/poddoor,
/obj/structure/fans/tiny,
/turf/open/floor/plasteel/tech/grid,
/area/ship/cargo)
"ah" = (
/obj/machinery/porta_turret,
/obj/structure/railing{
	icon_state = "railing";
	dir = 9
	},
/turf/open/floor/plating,
/area/ship/bridge)
"ai" = (
/turf/closed/wall/mineral/plastitanium/nodiagonal,
/area/ship/cargo)
"aj" = (
/obj/structure/railing{
	dir = 1
	},
/turf/open/floor/plating,
/area/ship/external)
"ak" = (
/obj/machinery/porta_turret,
/obj/structure/railing{
	dir = 1
	},
/turf/open/floor/plating,
/area/ship/bridge)
"al" = (
/obj/machinery/atmospherics/components/binary/pump{
	icon_state = "pump_map-3";
	dir = 1
	},
/turf/open/floor/plasteel/tech,
/area/ship/cargo)
"am" = (
/turf/open/floor/plasteel/tech/grid,
/area/ship/cargo)
"an" = (
/turf/open/floor/plasteel/tech,
/area/ship/cargo)
"ao" = (
/turf/closed/wall/mineral/plastitanium,
/area/ship/engineering)
"ap" = (
/obj/machinery/computer/warrant{
	icon_state = "computer";
	dir = 4
	},
/obj/machinery/firealarm{
	icon_state = "fire0";
	dir = 4;
	pixel_x = -28
	},
/turf/open/floor/plasteel/mono/dark,
/area/ship/bridge)
"aq" = (
/obj/machinery/airalarm/directional/north,
/obj/item/aiModule/core/freeformcore,
/turf/open/floor/plasteel/dark,
/area/ship/bridge)
"ar" = (
/obj/machinery/turretid{
	pixel_y = 32
	},
/obj/machinery/atmospherics/components/unary/vent_scrubber/on/layer3,
/obj/machinery/syndicatebomb{
	pixel_w = 1
	},
/turf/open/floor/plasteel/dark,
/area/ship/bridge)
"as" = (
/obj/machinery/light{
	icon_state = "tube";
	dir = 4
	},
/turf/open/floor/plasteel/tech,
/area/ship/cargo)
"at" = (
/obj/machinery/vending/security/marine,
/turf/open/floor/carpet/black,
/area/ship/crew)
"au" = (
/obj/machinery/door/airlock/external/glass,
/obj/structure/fans/tiny,
/obj/docking_port/mobile{
	icon_state = "pinonclose";
	dir = 2
	},
/turf/open/floor/plating,
/area/ship/crew)
"av" = (
/obj/machinery/atmospherics/pipe/simple/scrubbers{
	icon_state = "pipe11-3";
	dir = 1
	},
/obj/machinery/button/door{
	dir = 4;
	icon_state = "doorctrl";
	id = 1;
	pixel_x = -23
	},
/turf/open/floor/plasteel/tech/grid,
/area/ship/cargo)
"aw" = (
/obj/machinery/atmospherics/pipe/simple/supply/visible/layer2{
	icon_state = "pipe11-2";
	dir = 6
	},
/turf/open/floor/plasteel/tech/grid,
/area/ship/cargo)
"ax" = (
/obj/machinery/atmospherics/components/binary/pump/layer2{
	icon_state = "pump_map-2";
	dir = 8
	},
/turf/open/floor/plasteel/tech/grid,
/area/ship/cargo)
"ay" = (
/obj/machinery/atmospherics/components/unary/tank/air,
/turf/open/floor/plasteel/tech/grid,
/area/ship/cargo)
"az" = (
/obj/structure/window/plasma/reinforced{
	icon_state = "plasmarwindow";
	dir = 8
	},
/obj/structure/window/plasma/reinforced{
	icon_state = "plasmarwindow";
	dir = 1
	},
/turf/open/floor/engine/plasma,
/area/ship/engineering)
"aA" = (
/obj/structure/window/plasma/reinforced{
	icon_state = "plasmarwindow";
	dir = 1
	},
/obj/effect/turf_decal/atmos/plasma,
/turf/open/floor/engine/plasma,
/area/ship/engineering)
"aB" = (
/obj/structure/window/plasma/reinforced{
	icon_state = "plasmarwindow";
	dir = 4
	},
/obj/structure/window/plasma/reinforced{
	icon_state = "plasmarwindow";
	dir = 1
	},
/turf/open/floor/engine/plasma,
/area/ship/engineering)
"aC" = (
/obj/machinery/computer/upload/borg{
	icon_state = "computer";
	dir = 4
	},
/obj/item/radio/intercom{
	pixel_x = -25;
	pixel_y = -11
	},
/obj/item/radio/intercom/wideband{
	pixel_x = -25;
	pixel_y = 5
	},
/turf/open/floor/plasteel/mono/dark,
/area/ship/bridge)
"aD" = (
/obj/effect/landmark/start/warden{
	name = "Lieutenant"
	},
/turf/open/floor/plasteel/dark,
/area/ship/bridge)
"aE" = (
/obj/machinery/holopad/emergency/command,
/obj/machinery/atmospherics/pipe/simple/scrubbers,
/turf/open/floor/plasteel/dark,
/area/ship/bridge)
"aF" = (
/obj/machinery/computer/helm{
	dir = 8
	},
/turf/open/floor/plasteel/mono/dark,
/area/ship/bridge)
"aG" = (
/obj/machinery/computer/cryopod{
	pixel_y = 25
	},
/obj/machinery/cryopod,
/turf/open/floor/carpet/black,
/area/ship/crew)
"aH" = (
/obj/machinery/suit_storage_unit,
/obj/item/clothing/suit/space/hardsuit/solgov{
	name = "Ultra-Mobility Hardsuit"
	},
/obj/item/tank/jetpack/oxygen,
/turf/open/floor/plasteel/tech/grid,
/area/ship/cargo)
"aI" = (
/obj/machinery/light{
	icon_state = "tube";
	dir = 1
	},
/turf/open/floor/carpet/black,
/area/ship/crew)
"aJ" = (
/obj/machinery/vending/sovietsoda,
/turf/open/floor/carpet/black,
/area/ship/crew)
"aK" = (
/obj/machinery/atmospherics/pipe/manifold/scrubbers{
	icon_state = "manifold-3";
	dir = 8
	},
/obj/machinery/firealarm{
	icon_state = "fire0";
	dir = 4;
	pixel_x = -28
	},
/turf/open/floor/plasteel/tech,
/area/ship/cargo)
"aL" = (
/obj/machinery/atmospherics/pipe/simple/supply/visible/layer2,
/obj/machinery/atmospherics/pipe/simple/scrubbers{
	icon_state = "pipe11-3";
	dir = 4
	},
/turf/open/floor/plasteel/tech/grid,
/area/ship/cargo)
"aM" = (
/obj/machinery/atmospherics/components/unary/vent_scrubber/on/layer3{
	icon_state = "scrub_map_on-3";
	dir = 8
	},
/turf/open/floor/plasteel/tech,
/area/ship/cargo)
"aN" = (
/obj/machinery/suit_storage_unit,
/obj/item/clothing/suit/space/hardsuit/security/independent/inteq{
	armor = list("melee"=35,"bullet"=25,"laser"=20,"energy"=70,"bomb"=50,"bio"=100,"rad"=100,"fire"=100,"acid"=100);
	name = "Armored engieneer hardsuit"
	},
/obj/item/tank/jetpack/oxygen,
/turf/open/floor/plasteel/tech,
/area/ship/cargo)
"aO" = (
/obj/structure/window/plasma/reinforced,
/obj/structure/window/plasma/reinforced{
	icon_state = "plasmarwindow";
	dir = 8
	},
/obj/structure/window/plasma/reinforced{
	icon_state = "plasmarwindow";
	dir = 1
	},
/turf/open/floor/engine/plasma,
/area/ship/engineering)
"aP" = (
/obj/structure/window/plasma/reinforced,
/turf/open/floor/engine/plasma,
/area/ship/engineering)
"aQ" = (
/obj/machinery/suit_storage_unit,
/obj/item/clothing/suit/space/hardsuit/syndi/elite{
	desc = "Brutal and heavy armor for ELITE hevy-troopers. Stile and armor!";
	name = "Heavy combat hardsuite"
	},
/obj/item/tank/jetpack/oxygen,
/turf/open/floor/plasteel/tech,
/area/ship/cargo)
"aR" = (
/obj/structure/window/plasma/reinforced,
/obj/structure/window/plasma/reinforced{
	icon_state = "plasmarwindow";
	dir = 4
	},
/obj/machinery/atmospherics/components/unary/vent_pump/on/layer4,
/turf/open/floor/engine/plasma,
/area/ship/engineering)
"aS" = (
/obj/machinery/computer/communications{
	icon_state = "computer";
	dir = 8
	},
/obj/machinery/readybutton{
	pixel_y = 27
	},
/obj/machinery/light{
	icon_state = "tube";
	dir = 1
	},
/turf/open/floor/plasteel/mono/dark,
/area/ship/bridge)
"aT" = (
/obj/machinery/computer/upload/ai{
	icon_state = "computer";
	dir = 4
	},
/obj/machinery/light,
/turf/open/floor/plasteel/mono/dark,
/area/ship/bridge)
"aU" = (
/obj/structure/cable{
	icon_state = "2-8"
	},
/obj/machinery/atmospherics/components/unary/vent_pump/on/layer2,
/obj/machinery/atmospherics/pipe/simple/scrubbers,
/turf/open/floor/plasteel/dark,
/area/ship/bridge)
"aV" = (
/obj/machinery/computer/bounty{
	icon_state = "computer";
	dir = 8
	},
/turf/open/floor/plasteel/mono/dark,
/area/ship/bridge)
"aW" = (
/obj/machinery/firealarm{
	icon_state = "fire0";
	dir = 4;
	pixel_x = -28
	},
/turf/open/floor/carpet/black,
/area/ship/crew)
"aX" = (
/obj/structure/cable{
	icon_state = "2-4"
	},
/obj/machinery/atmospherics/pipe/simple/scrubbers{
	icon_state = "pipe11-3";
	dir = 6
	},
/obj/machinery/atmospherics/pipe/simple/supply/hidden/layer2{
	icon_state = "pipe11-2";
	dir = 6
	},
/turf/open/floor/carpet/black,
/area/ship/crew)
"aY" = (
/obj/structure/cable{
	icon_state = "4-8"
	},
/obj/machinery/atmospherics/pipe/simple/scrubbers{
	icon_state = "pipe11-3";
	dir = 8
	},
/obj/machinery/atmospherics/pipe/simple/supply/hidden/layer2{
	icon_state = "pipe11-2";
	dir = 8
	},
/turf/open/floor/carpet/black,
/area/ship/crew)
"aZ" = (
/obj/machinery/door/firedoor/border_only{
	icon_state = "door_open";
	dir = 8
	},
/obj/machinery/door/firedoor/border_only{
	icon_state = "door_open";
	dir = 4
	},
/obj/machinery/door/window{
	icon_state = "left";
	dir = 4
	},
/obj/structure/cable{
	icon_state = "4-8"
	},
/obj/machinery/atmospherics/pipe/simple/scrubbers{
	icon_state = "pipe11-3";
	dir = 8
	},
/obj/machinery/atmospherics/pipe/simple/supply/hidden/layer2{
	icon_state = "pipe11-2";
	dir = 8
	},
/turf/open/floor/plasteel/stairs{
	icon_state = "stairs";
	dir = 8
	},
/area/ship/cargo)
"ba" = (
/obj/structure/cable{
	icon_state = "4-8"
	},
/obj/machinery/atmospherics/pipe/simple/supply/visible/layer2{
	icon_state = "pipe11-2";
	dir = 8
	},
/obj/machinery/atmospherics/pipe/simple/scrubbers{
	icon_state = "pipe11-3";
	dir = 9
	},
/turf/open/floor/plasteel/tech/grid,
/area/ship/cargo)
"bb" = (
/obj/structure/cable{
	icon_state = "2-8"
	},
/obj/machinery/atmospherics/pipe/manifold4w/supply/visible/layer2,
/turf/open/floor/plasteel/tech/grid,
/area/ship/cargo)
"bc" = (
/obj/machinery/atmospherics/components/unary/vent_pump/on/layer2{
	icon_state = "vent_map_on-2";
	dir = 8
	},
/turf/open/floor/plasteel/tech/grid,
/area/ship/cargo)
"bd" = (
/obj/machinery/suit_storage_unit,
/obj/item/clothing/suit/space/hardsuit/syndi/elite{
	desc = "Brutal and heavy armor for ELITE hevy-troopers. Stile and armor!";
	name = "Heavy combat hardsuite"
	},
/obj/item/tank/jetpack/oxygen,
/turf/open/floor/plasteel/tech/grid,
/area/ship/cargo)
"be" = (
/obj/machinery/power/shuttle/engine/fueled/plasma{
	icon_state = "burst_plasma";
	dir = 4
	},
/turf/open/floor/plating,
/area/ship/engineering)
"bf" = (
/obj/machinery/atmospherics/components/unary/shuttle/heater/tank{
	icon_state = "heater_pipe";
	dir = 4
	},
/obj/structure/window/reinforced{
	icon_state = "rwindow";
	dir = 8
	},
/turf/open/floor/plasteel/dark,
/area/ship/engineering)
"bg" = (
/obj/machinery/atmospherics/pipe/manifold/brown/visible/layer4{
	dir = 1
	},
/turf/open/floor/plasteel/dark,
/area/ship/engineering)
"bh" = (
/obj/machinery/atmospherics/components/unary/vent_scrubber/on/layer3,
/obj/machinery/atmospherics/components/binary/pump/layer4{
	dir = 8
	},
/turf/open/floor/plasteel/mono/dark,
/area/ship/engineering)
"bi" = (
/obj/machinery/power/apc/auto_name/directional/south,
/obj/structure/cable{
	icon_state = "0-4"
	},
/turf/open/floor/plasteel/dark,
/area/ship/bridge)
"bj" = (
/obj/machinery/door/airlock/highsecurity,
/obj/structure/cable{
	icon_state = "1-2"
	},
/obj/machinery/atmospherics/pipe/simple/supply/visible/layer2,
/obj/machinery/atmospherics/pipe/simple/scrubbers,
/turf/open/floor/plasteel/dark,
/area/ship/bridge)
"bk" = (
/obj/machinery/power/apc/auto_name/directional/east,
/obj/structure/cable{
	icon_state = "0-2"
	},
/obj/machinery/light{
	icon_state = "tube";
	dir = 4
	},
/obj/machinery/atmospherics/pipe/simple/brown/visible/layer4{
	icon_state = "pipe11-4";
	dir = 9
	},
/turf/open/floor/plasteel/tech,
/area/ship/engineering)
"bl" = (
/obj/structure/cable{
	icon_state = "1-2"
	},
/obj/machinery/atmospherics/pipe/simple/scrubbers{
	icon_state = "pipe11-3";
	dir = 1
	},
/obj/machinery/atmospherics/pipe/manifold/supply/hidden/layer2{
	icon_state = "manifold-2";
	dir = 8
	},
/turf/open/floor/carpet/black,
/area/ship/crew)
"bm" = (
/obj/machinery/atmospherics/components/unary/vent_pump/on/layer2{
	icon_state = "vent_map_on-2";
	dir = 8
	},
/turf/open/floor/carpet/black,
/area/ship/crew)
"bn" = (
/obj/machinery/vending/snack/random,
/turf/open/floor/carpet/black,
/area/ship/crew)
"bo" = (
/obj/machinery/atmospherics/components/unary/vent_scrubber/on/layer3,
/obj/machinery/light{
	icon_state = "tube";
	dir = 8
	},
/obj/machinery/power/apc/auto_name/directional/west,
/obj/structure/cable{
	icon_state = "0-2"
	},
/turf/open/floor/carpet/black,
/area/ship/crew)
"bp" = (
/obj/structure/cable{
	icon_state = "1-2"
	},
/obj/machinery/atmospherics/pipe/simple/supply/visible/layer2,
/turf/open/floor/plasteel/tech/grid,
/area/ship/cargo)
"bq" = (
/obj/machinery/atmospherics/pipe/manifold/brown/visible/layer4{
	icon_state = "manifold-4";
	dir = 4
	},
/turf/open/floor/plasteel/dark,
/area/ship/engineering)
"br" = (
/obj/machinery/atmospherics/pipe/simple/supply/visible/layer2{
	icon_state = "pipe11-2";
	dir = 6
	},
/obj/machinery/atmospherics/pipe/simple/scrubbers{
	icon_state = "pipe11-3";
	dir = 5
	},
/turf/open/floor/plasteel/mono/dark,
/area/ship/engineering)
"bs" = (
/obj/structure/cable{
	icon_state = "1-2"
	},
/obj/structure/cable{
	icon_state = "2-4"
	},
/obj/machinery/atmospherics/pipe/simple/supply/visible/layer2{
	icon_state = "pipe11-2";
	dir = 4
	},
/obj/machinery/atmospherics/pipe/simple/scrubbers{
	icon_state = "pipe11-3";
	dir = 8
	},
/turf/open/floor/plasteel/stairs{
	icon_state = "stairs";
	dir = 8
	},
/area/ship/engineering)
"bt" = (
/obj/machinery/door/firedoor/border_only{
	icon_state = "door_open";
	dir = 8
	},
/obj/machinery/door/firedoor/border_only{
	icon_state = "door_open";
	dir = 4
	},
/obj/machinery/door/window{
	icon_state = "left";
	dir = 8
	},
/obj/structure/cable{
	icon_state = "4-8"
	},
/obj/machinery/atmospherics/pipe/simple/supply/visible/layer2{
	icon_state = "pipe11-2";
	dir = 4
	},
/obj/machinery/atmospherics/pipe/simple/scrubbers{
	icon_state = "pipe11-3";
	dir = 8
	},
/turf/open/floor/plasteel/tech/grid,
/area/ship/engineering)
"bu" = (
/obj/structure/cable{
	icon_state = "4-8"
	},
/obj/machinery/atmospherics/pipe/simple/supply/visible/layer2{
	icon_state = "pipe11-2";
	dir = 4
	},
/obj/machinery/atmospherics/pipe/simple/scrubbers{
	icon_state = "pipe11-3";
	dir = 8
	},
/turf/open/floor/plasteel/tech/grid,
/area/ship/engineering)
"bv" = (
/obj/structure/cable{
	icon_state = "4-8"
	},
/obj/structure/cable{
	icon_state = "1-8"
	},
/obj/structure/cable{
	icon_state = "2-8"
	},
/obj/machinery/atmospherics/pipe/manifold4w/supply/visible/layer2,
/obj/machinery/atmospherics/pipe/manifold4w/scrubbers,
/turf/open/floor/plasteel/tech/grid,
/area/ship/engineering)
"bw" = (
/obj/machinery/door/firedoor/border_only{
	icon_state = "door_open";
	dir = 8
	},
/obj/machinery/door/firedoor/border_only{
	icon_state = "door_open";
	dir = 4
	},
/obj/machinery/door/window{
	icon_state = "left";
	dir = 4
	},
/obj/structure/cable{
	icon_state = "4-8"
	},
/obj/machinery/atmospherics/pipe/simple/scrubbers{
	icon_state = "pipe11-3";
	dir = 8
	},
/obj/machinery/atmospherics/pipe/simple/supply/hidden/layer2{
	icon_state = "pipe11-2";
	dir = 8
	},
/turf/open/floor/plasteel/tech/grid,
/area/ship/crew)
"bx" = (
/obj/structure/cable{
	icon_state = "4-8"
	},
/obj/machinery/atmospherics/pipe/manifold4w/scrubbers,
/obj/machinery/atmospherics/pipe/simple/supply/hidden/layer2{
	icon_state = "pipe11-2";
	dir = 8
	},
/obj/structure/cable{
	icon_state = "1-8"
	},
/turf/open/floor/carpet/black,
/area/ship/crew)
"by" = (
/obj/structure/cable{
	icon_state = "1-8"
	},
/obj/machinery/atmospherics/pipe/simple/scrubbers{
	icon_state = "pipe11-3";
	dir = 9
	},
/obj/machinery/atmospherics/pipe/manifold/supply/hidden/layer2{
	icon_state = "manifold-2";
	dir = 4
	},
/turf/open/floor/carpet/black,
/area/ship/crew)
"bz" = (
/obj/machinery/light{
	icon_state = "tube";
	dir = 8
	},
/obj/machinery/portable_atmospherics/canister/oxygen,
/turf/open/floor/plasteel/tech,
/area/ship/cargo)
"bA" = (
/turf/open/floor/carpet/black,
/area/ship/crew)
"bB" = (
/obj/structure/cable{
	icon_state = "1-8"
	},
/obj/machinery/atmospherics/pipe/simple/supply/visible/layer2,
/turf/open/floor/plasteel/tech/grid,
/area/ship/cargo)
"bC" = (
/obj/machinery/airalarm/directional/east,
/obj/structure/tank_dispenser,
/turf/open/floor/plasteel/tech/grid,
/area/ship/cargo)
"bD" = (
/obj/machinery/atmospherics/pipe/manifold/brown/visible/layer4,
/turf/open/floor/plasteel/dark,
/area/ship/engineering)
"bE" = (
/obj/machinery/atmospherics/pipe/simple/supply/visible/layer2,
/obj/machinery/atmospherics/components/binary/pump/layer4{
	dir = 8
	},
/turf/open/floor/plasteel/mono/dark,
/area/ship/engineering)
"bF" = (
/obj/machinery/airalarm/directional/east,
/obj/structure/cable{
	icon_state = "1-2"
	},
/obj/machinery/atmospherics/pipe/simple/brown/visible/layer4{
	icon_state = "pipe11-4";
	dir = 10
	},
/turf/open/floor/plasteel/tech,
/area/ship/engineering)
"bG" = (
/turf/closed/wall/mineral/plastitanium/nodiagonal,
/area/ship/bridge)
"bH" = (
/obj/machinery/door/airlock/highsecurity,
/obj/structure/cable{
	icon_state = "1-2"
	},
/obj/machinery/atmospherics/pipe/simple/supply/visible/layer2,
/obj/machinery/atmospherics/pipe/simple/scrubbers,
/turf/open/floor/plasteel/dark,
/area/ship/security/armory)
"bI" = (
/obj/machinery/power/apc/auto_name/directional/west,
/obj/structure/cable{
	icon_state = "0-4"
	},
/obj/machinery/portable_atmospherics/canister/oxygen,
/turf/open/floor/plasteel/tech/grid,
/area/ship/cargo)
"bJ" = (
/obj/machinery/atmospherics/pipe/manifold/supply/hidden/layer2{
	icon_state = "manifold-2";
	dir = 8
	},
/turf/open/floor/carpet/black,
/area/ship/crew)
"bK" = (
/obj/machinery/vending/cola/random,
/turf/open/floor/carpet/black,
/area/ship/crew)
"bL" = (
/obj/machinery/atmospherics/pipe/simple/supply/visible/layer2,
/turf/open/floor/plasteel/tech/grid,
/area/ship/cargo)
"bM" = (
/obj/machinery/suit_storage_unit,
/obj/item/clothing/suit/space/hardsuit/solgov{
	name = "Ultra-Mobility Hardsuit"
	},
/obj/item/tank/jetpack/oxygen,
/turf/open/floor/plasteel/tech,
/area/ship/cargo)
"bN" = (
/obj/structure/closet/syndicate,
/obj/item/clothing/suit/armor/vest/marine/heavy,
/obj/item/clothing/head/helmet/marine/engineer,
/obj/item/storage/backpack/ert/engineer,
/obj/item/stack/sheet/metal/fifty,
/obj/item/stack/sheet/metal/fifty,
/obj/item/stack/sheet/mineral/titanium/fifty,
/obj/item/stack/sheet/mineral/plasma/fifty,
/obj/item/stack/sheet/mineral/plasma/fifty,
/obj/item/storage/belt/utility/full/ert,
/obj/item/deployable_turret_folded,
/obj/item/gun/ballistic/shotgun/automatic/combat/compact,
/obj/item/storage/backpack/duffelbag/syndie/ammo/shotgun,
/obj/item/storage/backpack/duffelbag/syndie/c4,
/obj/item/storage/toolbox/ammo/shotgun,
/obj/structure/window/reinforced{
	icon_state = "rwindow";
	dir = 8
	},
/obj/item/pipe_dispenser,
/obj/item/construction/rcd/combat,
/obj/item/rcd_ammo/large,
/obj/item/rcd_ammo/large,
/obj/item/rcd_ammo/large,
/turf/open/floor/plasteel/dark,
/area/ship/engineering)
"bO" = (
/obj/effect/landmark/start/station_engineer{
	name = "Combat Engineer"
	},
/turf/open/floor/plasteel/dark,
/area/ship/engineering)
"bP" = (
/obj/machinery/atmospherics/components/unary/vent_pump/on/layer2{
	icon_state = "vent_map_on-2";
	dir = 1
	},
/turf/open/floor/plasteel/mono/dark,
/area/ship/engineering)
"bQ" = (
/obj/structure/cable{
	icon_state = "1-2"
	},
/obj/machinery/portable_atmospherics/canister/toxins,
/obj/machinery/atmospherics/components/unary/portables_connector/visible/layer4{
	dir = 1
	},
/turf/open/floor/plasteel/tech,
/area/ship/engineering)
"bR" = (
/obj/structure/closet/syndicate,
/obj/item/gun/ballistic/automatic/assualt/ak47{
	dry_fire_text = "CYKA BLYAT!!!"
	},
/obj/item/gun/ballistic/shotgun/automatic/combat/compact,
/obj/item/melee/classic_baton/telescopic/contractor_baton,
/obj/item/storage/toolbox/ammo/shotgun,
/obj/item/storage/toolbox/ammo/a762_39,
/obj/item/storage/toolbox/ammo/a762_39,
/obj/item/ammo_box/magazine/ak47,
/obj/item/ammo_box/magazine/ak47,
/obj/item/ammo_box/magazine/ak47,
/obj/item/clothing/suit/armor/vest/marine/medium,
/obj/item/clothing/head/helmet/riot{
	armor = list("melee"=40,"bullet"=40,"laser"=40,"energy"=40,"bomb"=40,"bio"=30,"rad"=0,"fire"=100,"acid"=100);
	desc = "It's a helmet specifically designed to protect against any attacks.";
	name = "Ranger helmet"
	},
/obj/item/storage/belt/military,
/obj/item/storage/backpack/ert/security,
/obj/item/clothing/mask/gas/sechailer/swat/spacepol{
	name = "Utility gas mask"
	},
/obj/item/tank/internals/tactical,
/turf/open/floor/plasteel/mono/dark,
/area/ship/security/armory)
"bS" = (
/obj/machinery/power/apc/auto_name/directional/north,
/obj/machinery/power/terminal{
	icon_state = "term";
	dir = 1
	},
/obj/effect/landmark/start/security_officer{
	name = "Assault Trooper"
	},
/obj/structure/cable{
	icon_state = "0-4"
	},
/turf/open/floor/plasteel/dark,
/area/ship/security/armory)
"bT" = (
/obj/effect/landmark/start/security_officer{
	name = "Assault Trooper"
	},
/obj/structure/cable{
	icon_state = "1-8"
	},
/obj/machinery/atmospherics/components/unary/vent_pump/on/layer2{
	icon_state = "vent_map_on-2";
	dir = 1
	},
/obj/machinery/atmospherics/pipe/simple/scrubbers,
/turf/open/floor/plasteel/dark,
/area/ship/security/armory)
"bU" = (
/obj/machinery/atmospherics/pipe/simple/supply/hidden/layer2{
	icon_state = "pipe11-2";
	dir = 5
	},
/turf/open/floor/carpet/black,
/area/ship/crew)
"bV" = (
/obj/machinery/atmospherics/pipe/simple/supply/hidden/layer2{
	icon_state = "pipe11-2";
	dir = 8
	},
/turf/open/floor/carpet/black,
/area/ship/crew)
"bW" = (
/obj/machinery/door/firedoor/border_only{
	icon_state = "door_open";
	dir = 8
	},
/obj/machinery/door/firedoor/border_only{
	icon_state = "door_open";
	dir = 4
	},
/obj/machinery/door/window{
	icon_state = "left";
	dir = 4
	},
/obj/machinery/atmospherics/pipe/simple/supply/hidden/layer2{
	icon_state = "pipe11-2";
	dir = 8
	},
/turf/open/floor/plasteel/stairs{
	icon_state = "stairs";
	dir = 8
	},
/area/ship/cargo)
"bX" = (
/obj/machinery/atmospherics/pipe/simple/supply/visible/layer2{
	icon_state = "pipe11-2";
	dir = 8
	},
/turf/open/floor/plasteel/tech/grid,
/area/ship/cargo)
"bY" = (
/obj/machinery/atmospherics/pipe/manifold/supply/visible/layer2,
/turf/open/floor/plasteel/tech/grid,
/area/ship/cargo)
"bZ" = (
/obj/structure/cable{
	icon_state = "0-4"
	},
/obj/machinery/power/rtg/advanced,
/turf/open/floor/plasteel/dark,
/area/ship/engineering)
"ca" = (
/obj/machinery/power/terminal{
	dir = 4
	},
/obj/structure/cable{
	icon_state = "0-8"
	},
/obj/machinery/firealarm{
	icon_state = "fire0";
	dir = 1;
	pixel_y = -27
	},
/obj/machinery/power/port_gen/pacman,
/turf/open/floor/plasteel/mono/dark,
/area/ship/engineering)
"cb" = (
/obj/machinery/airalarm/directional/west,
/obj/machinery/atmospherics/components/unary/vent_scrubber/on/layer3{
	icon_state = "scrub_map_on-3";
	dir = 1
	},
/obj/machinery/light{
	icon_state = "tube";
	dir = 8
	},
/turf/open/floor/carpet/black,
/area/ship/crew)
"cc" = (
/obj/effect/landmark/start/security_officer{
	name = "Assault Trooper"
	},
/turf/open/floor/plasteel/dark,
/area/ship/security/armory)
"cd" = (
/obj/effect/landmark/start/security_officer{
	name = "Heavy Trooper"
	},
/obj/machinery/atmospherics/pipe/simple/scrubbers,
/turf/open/floor/plasteel/dark,
/area/ship/security/armory)
"ce" = (
/obj/structure/closet/syndicate,
/obj/item/gun/ballistic/automatic/hmg/l6_saw,
/obj/item/gun/ballistic/shotgun/bulldog,
/obj/item/melee/powerfist,
/obj/item/storage/toolbox/ammo/shotgun,
/obj/item/ammo_box/magazine/mm712x82,
/obj/item/ammo_box/magazine/mm712x82,
/obj/item/ammo_box/magazine/mm712x82,
/obj/item/ammo_box/magazine/mm712x82,
/obj/item/clothing/suit/armor/vest/marine/heavy,
/obj/item/clothing/head/helmet/marine,
/obj/item/storage/belt/military,
/obj/item/storage/backpack/ert/security,
/obj/item/clothing/mask/gas/sechailer/swat/spacepol{
	name = "Utility gas mask"
	},
/obj/item/tank/internals/tactical,
/turf/open/floor/plasteel/mono/dark,
/area/ship/security/armory)
"cf" = (
/obj/machinery/vending/coffee,
/turf/open/floor/carpet/black,
/area/ship/crew)
"cg" = (
/obj/machinery/porta_turret,
/obj/structure/railing{
	icon_state = "railing";
	dir = 10
	},
/turf/open/floor/plating,
/area/ship/bridge)
"ch" = (
/obj/machinery/airalarm/directional/south,
/obj/effect/landmark/start/security_officer{
	name = "Assault Trooper"
	},
/turf/open/floor/plasteel/dark,
/area/ship/security/armory)
"ci" = (
/obj/effect/landmark/start/security_officer{
	name = "Heavy Trooper"
	},
/obj/machinery/atmospherics/components/unary/vent_scrubber/on/layer3{
	icon_state = "scrub_map_on-3";
	dir = 1
	},
/obj/machinery/firealarm{
	icon_state = "fire0";
	dir = 1;
	pixel_y = -27
	},
/turf/open/floor/plasteel/dark,
/area/ship/security/armory)
"cj" = (
/obj/structure/railing,
/turf/open/floor/plating,
/area/ship/external)
"ck" = (
/obj/machinery/porta_turret,
/obj/structure/railing,
/turf/open/floor/plating,
/area/ship/bridge)
"cl" = (
/obj/machinery/recharge_station,
/turf/open/floor/carpet/black,
/area/ship/crew)
"cm" = (
/obj/machinery/door/airlock/external/glass,
/obj/structure/fans/tiny,
/turf/open/floor/plating,
/area/ship/crew)
"cn" = (
/obj/structure/closet/syndicate,
/obj/item/gun/ballistic/automatic/assualt/ak47{
	dry_fire_text = "CYKA BLYAT!!!"
	},
/obj/item/gun/ballistic/shotgun/automatic/combat/compact,
/obj/item/melee/classic_baton/telescopic/contractor_baton,
/obj/item/storage/toolbox/ammo/shotgun,
/obj/item/storage/toolbox/ammo/a762_39,
/obj/item/storage/toolbox/ammo/a762_39,
/obj/item/ammo_box/magazine/ak47,
/obj/item/ammo_box/magazine/ak47,
/obj/item/ammo_box/magazine/ak47,
/obj/item/clothing/suit/armor/vest/marine/medium,
/obj/item/clothing/head/helmet/riot{
	armor = list("melee"=40,"bullet"=40,"laser"=40,"energy"=40,"bomb"=40,"bio"=30,"rad"=0,"fire"=100,"acid"=100);
	desc = "It's a helmet specifically designed to protect against any attacks.";
	name = "Ranger helmet"
	},
/obj/item/storage/belt/military,
/obj/item/storage/backpack/ert/security,
/obj/item/clothing/mask/gas/sechailer/swat/spacepol{
	name = "Utility gas mask"
	},
/obj/machinery/light{
	icon_state = "tube";
	dir = 1
	},
/obj/item/tank/internals/tactical,
/turf/open/floor/plasteel/mono/dark,
/area/ship/security/armory)
"co" = (
/obj/machinery/power/smes/engineering,
/obj/structure/cable,
/obj/machinery/light,
/turf/open/floor/plasteel/tech,
/area/ship/engineering)
"cp" = (
/obj/machinery/light,
/turf/open/floor/carpet/black,
/area/ship/crew)
"cq" = (
/obj/structure/closet/syndicate,
/obj/item/gun/ballistic/automatic/hmg/l6_saw,
/obj/item/gun/ballistic/shotgun/bulldog,
/obj/item/melee/powerfist,
/obj/item/storage/toolbox/ammo/shotgun,
/obj/item/ammo_box/magazine/mm712x82,
/obj/item/ammo_box/magazine/mm712x82,
/obj/item/ammo_box/magazine/mm712x82,
/obj/item/ammo_box/magazine/mm712x82,
/obj/item/clothing/suit/armor/vest/marine/heavy,
/obj/item/clothing/head/helmet/marine,
/obj/item/storage/belt/military,
/obj/item/storage/backpack/ert/security,
/obj/item/clothing/mask/gas/sechailer/swat/spacepol{
	name = "Utility gas mask"
	},
/obj/machinery/light,
/obj/item/tank/internals/tactical,
/turf/open/floor/plasteel/mono/dark,
/area/ship/security/armory)
"cr" = (
/turf/closed/wall/mineral/plastitanium/nodiagonal,
/area/ship/engineering)
"cs" = (
/turf/closed/wall/mineral/plastitanium/nodiagonal,
/area/ship/crew)
"ct" = (
/turf/closed/wall/mineral/plastitanium/nodiagonal,
/area/ship/security/armory)

(1,1,1) = {"
aa
aa
aa
ah
ao
ao
be
be
be
ao
ao
cg
aa
aa
aa
"}
(2,1,1) = {"
aa
aa
aa
cr
cr
aO
bf
bf
bf
bN
cr
cr
aa
aa
aa
"}
(3,1,1) = {"
aa
aa
aa
cr
az
aP
bg
bq
bD
bO
bZ
cr
aa
aa
aa
"}
(4,1,1) = {"
aa
aa
aa
cr
aA
aP
bh
br
bE
bP
ca
cr
aa
aa
aa
"}
(5,1,1) = {"
aa
aa
ah
cr
aB
aR
bk
bs
bF
bQ
co
cr
cg
aa
aa
"}
(6,1,1) = {"
aa
aa
bG
bG
bG
bG
bG
bt
ct
ct
ct
ct
ct
aa
aa
"}
(7,1,1) = {"
aa
aa
bG
ap
aC
aT
bG
bu
ct
cn
bR
bR
ct
aa
aa
"}
(8,1,1) = {"
aa
aa
bG
aq
aD
bi
bG
bu
ct
bS
cc
ch
ct
aa
aa
"}
(9,1,1) = {"
aa
aa
bG
ar
aE
aU
bj
bv
bH
bT
cd
ci
ct
aa
aa
"}
(10,1,1) = {"
aa
aa
bG
aS
aF
aV
bG
bu
ct
bR
ce
cq
ct
aa
aa
"}
(11,1,1) = {"
aa
aa
bG
bG
bG
bG
bG
bw
ct
ct
ct
ct
ct
aa
aa
"}
(12,1,1) = {"
aa
aa
ab
cs
aG
aW
bo
bx
cb
bA
cl
cs
ab
aa
aa
"}
(13,1,1) = {"
aa
aa
aj
au
bA
aX
bl
by
bJ
bU
bA
cm
cj
aa
aa
"}
(14,1,1) = {"
aa
aa
aj
cs
aI
aY
bm
bA
bm
bV
cp
cs
cj
aa
aa
"}
(15,1,1) = {"
ab
ab
ak
cs
aJ
aY
bn
at
bK
bV
cf
cs
ck
ab
ab
"}
(16,1,1) = {"
ab
ai
ai
ai
ai
aZ
ai
ai
ai
bW
ai
ai
ai
ai
ab
"}
(17,1,1) = {"
ac
af
al
av
aK
ba
bz
bI
bz
bX
an
am
an
ag
ab
"}
(18,1,1) = {"
ab
ag
am
aw
aL
bb
bp
bB
bL
bY
am
am
am
ag
ab
"}
(19,1,1) = {"
ab
ag
as
ax
aM
bc
an
am
an
bc
an
am
as
ag
ab
"}
(20,1,1) = {"
ad
ae
ae
ay
aN
bd
aQ
bC
bM
aH
bM
aH
ae
ae
ad
"}
(21,1,1) = {"
aa
aa
ae
ae
ae
ae
ae
ae
ae
ae
ae
ae
ae
aa
aa
"}
